Phage Name	Cluster	Subcluster
20ES	A	A2
244	E	None
32HC	Z	None
39HC	B	B6
40AC	A	A17
40BC	B	B6
A3Wally	GD	GD1
Aaronocolus	BD	BD1
Abba	AO	AO3
AbbeyMikolon	BL	None
Abblin	DE	DE4
AbbyDaisy	AY	None
AbbyPaige	A	A2
Abbyshoes	A	A1
AbbysRanger	A	A4
ABCat	E	None
Abdiel	A	A4
Abidatro	AS	AS1
Abigail	EB	None
Abinghost	B	B3
Ablatia	C	C1
Abrogate	A	A1
Abscondus	CQ	CQ1
AbsoluteMadLad	B	B1
Abt2graduatex2	BG	None
ABU	B	B1
Acadian	B	B5
Acai	AU	AU1
ACFishhook	A	A3
Achebe	A	A4
Acme	A	A1
Acolyte	A	A2
Acosta	EA	EA1
Acquire49	L	L1
ActinUp	K	K1
Adahisdi	A	A1
Adaia	AX	None
AdaS	AY	None
Adat	AV	None
AddiRose	JA	None
Adelaide	EP	None
Adephagia	K	K1
Adgers	CS	CS2
Ading	C	C1
Adjutor	D	D1
Adlitam	C	C1
Adnama	E	None
Adolin	AZ	AZ1
Adonis	K	K1
Adora	CZ	CZ4
Adriana	B	B1
Adumb2043	AZ	AZ1
Adzzy	A	A2
Aegeus	L	L5
AEgle	AZ	AZ1
Aelin	B	B1
Aeneas	A	A1
Aesir	EF	None
Affeca	DE	DE1
AFIS	A	A1
Aflac	DJ	None
Agaliana	A	A1
Agape74	A	A2
Agatha	CT	None
Agent47	K	K5
Agente005	EA	EA1
AgentM	A	A5
Ageofdapage	K	K1
Aggie	N	None
Aglet	A	A3
AGrandiflora	AZ	AZ1
AgronaGT15	A	A3
Agueybana	CZ	CZ1
Ahwei	B	B4
AikoCarson	CT	None
Aikoy	AE	None
Aikyam	AY	None
Ailee	DE	DE1
AinMach	AZ	AZ7
Airmid	A	A5
Ajay	A	A1
Ajin	EF	None
Akhila	F	F1
Akino08	EB	None
Akoma	B	B3
Akoni	EK	EK2
AksarBAT	DR	None
AlainaMarie	DJ	None
Alakazam	EA	EA5
AlanGrant	B	B4
Alatato	FB	None
Alatin	CA	None
Albanese	AK	None
Albedo	EB	None
Albee	A	A4
Alberto7	A	A4
Albright	EB	None
Aledel	AK	None
Aleemily	DZ	None
Alephilan	DV	None
Alex44	EK	EK1
AlexAdler	EA	EA1
Alexphander	F	F1
Ali17	DE	DE2
Alice	C	C1
AlishaPH	K	K1
Aliter	A	A9
Alkhayr	O	None
AllBusiness	FF	None
Alleb	ED	ED1
Allegro	B	B2
AlleyCat	K	K5
Alma	A	A9
Aloe25	DJ	None
Aloeri	F	F1
AloeVera	EK	EK2
Aloki	DQ	None
Alone3	BS	None
Alpacados	CA	None
AlpineSix	F	F1
Alsaber	BD	BD3
Alsfro	A	A1
Altadena	FH	None
Altheas	EG	None
Altman	A	A1
Altostratus	FS	None
AltPhacts	B	B1
Altwerkus	B	B1
Alucard	EE	None
AlumE	CZ	CZ1
AluminumJesus	EG	None
Alvin	A	A1
Alvy	BD	BD2
Alyssamiracle	DV	None
Alyxandracam	EA	EA1
Amabiko	BE	BE2
Amao	E	None
Amataga	C	C1
Amavida	AQ	None
Amela	BD	BD3
Amelia	AS	AS2
Amelie	K	K1
AmericanBeauty	E	None
Amethyst	BD	BD2
Amgine	K	K6
AmiCi24	AS	AS3
Amigo	AQ	None
Aminay	K	K7
Amo99	CP	None
Amochick	Q	None
Amohnition	K	K6
Amok	CT	None
Amoonguss	DQ	None
Amore2	CS	CS1
Amyev	AZ	AZ1
Amymech	Q	None
AN3	A	A2
AN9	A	A2
Anakin	EF	None
Anamika	CS	CS3
Anansi	AQ	None
AnarQue	DR	None
Anatole	BV	None
Anaya	K	K1
Anaysia	A	A15
AnClar	DR	None
Anderson	B	B1
Andies	N	None
AndPeggy	CT	None
Andre	B	B1
Andrew	AS	AS3
Andris	BD	BD2
Andromedas	EA	EA2
Anedea	BE	BE1
Aneem	A	A11
Anekin	AY	None
Angel	G	G1
Angela	BE	BE1
AngelCake	B	B1
Angelica	K	K1
Angelicage	DE	DE1
Angelique	CY	CY1
Anglerfish	A	A1
AngryGiraffe	BE	BE2
AngryOrchard	CA	None
ANI8	A	A2
Anilorac	EA	EA1
Animus	BD	BD2
Anjali	FD	None
AnnabelLee	FR	None
Annadreamy	BK	BK1
AnnaL29	A	A2
AnnaLie	EB	None
Annalisa	CZ	CZ4
Annapurna	EF	None
AnnaSerena	EF	None
Annihilator	G	G1
Annihilus	BI	BI2
Annyong	A	A4
Anon	A	A15
Anselm	A	A2
Anseraureola	EE	None
Antares	EC	None
Anthony	A	A20
Antihero	B	B4
Antoinette	EA	EA1
Antonia	B	B1
Antonio	CZ	CZ1
Antrice	AS	AS2
Antsirabe	G	G5
Antuna	GA	None
Anubis	A	A3
Aoka	FO	None
Apeppi	DV	None
Apex	B	B4
Aphelion	CQ	CQ1
Apiary	CR	CR6
Apizium	B	B1
Apocalypse	K	K1
ApoKipo	AL	None
Appa	GA	None
AppleCider	AK	None
AppleCloud	CA	None
Applecrisp	K	K6
Applejack	A	A1
Appletree2	L	L1
Apricot	DN	DN3
APunk	DE	DE4
Aquarius	BU	None
Araceli	BH	None
Aragog	A	A5
AranulaLuti	EA	EA1
Arataki	DJ	None
Araxxi	EM	EM1
Arbiter	B	B2
Arby	AN	None
Arcadia	AM	None
Arcanine	A	A1
ArcherNM	A	A2
ArcherS7	C	C1
Archetta	A	A5
ArchiDore	DW	None
Archie	L	L2
Archimedes	DA	None
Archis	CV	None
ArcusAngelus	F	F1
Ardmore	F	F1
AreFloNak	AU	AU1
Ares	B	B2
Arete	EM	EM1
Argan	AU	AU6
Argena	DQ	None
Argent26	E	None
Argie	W	None
Ariadne	EC	None
Arianna	EO	None
Arib1	P	P1
Ariel	J	None
Arielagos	AN	None
Aries55	EE	None
Arissanae	A	A9
ArizonaGT	BP	None
Arlo	A	A1
ArMaWen	EK	EK1
Armstrong	EB	None
Aroostook	G	G1
Arri	DC	DC1
Arroyo	EB	None
Artemis2UCLA	A	A6
Arti	CR	CR2
Artiphact	EF	None
Artorias	DJ	None
Arturo	A	A4
ArV1	AR	None
ArV2	Singleton	None
Arzan	FI	None
Asa16	AZ	AZ1
Asapag	DN	DN1
Asayake	K	K1
Ascela	AZ	AZ1
ASegato	ED	ED2
ASerpRocky	CS	CS4
Ashballer	A	A1
Ashertheman	DE	DE1
Ashes	AZ	AZ5
Ashraf	B	B1
Ashton	EK	EK2
Ashwin	O	None
Asis	BG	None
Asriel	E	None
Asta	EA	EA1
Astartes	EK	EK2
Asten	BD	BD1
Asterius	C	C1
Astraea	C	C1
Astralis	DV	None
Astro	A	A8
Astro16	EE	None
ATCC29399BC	BU	None
ATCC29399BT	BU	None
Atcoo	P	P1
Athena	B	B3
Atiba	K	K1
Atkinbua	A	A1
Atlantean	C	C1
Atlantica	AS	AS3
Atraxa	AX	None
Atraxi	EK	EK2
Attacne	BU	None
Attis	CZ	CZ2
Attoomi	Singleton	None
Atuin	FC	None
Aubergine	EA	EA1
Aubs	F	F1
Audell	FR	None
Audrey	B	B3
Audrick	C	C1
AugsMagnumOpus	A	A3
AuntGwenStacy	Y	None
Auspice	M	M1
Austelle	B	B4
Austin	CS	CS1
AustinPowers	AK	None
Austintatious	BC	BC3
Auxilium	AY	None
Ava3	C	C1
AvadaKedavra	L	L1
Avani	F	F2
AvatarAhPeg	A	A4
Avazak	DJ	None
AvGardian	EB	None
Avian	DV	None
Avle17	A	A4
Avocado	G	G2
Avocadoman	EB	None
Avrafan	G	G1
Avvas	EE	None
Awesomesauce	F	F1
AWGoat	AP	AP4
AxeJC	BP	None
Axiom	BD	BD2
AxiPup	EA	EA1
Axumite	DR	None
Axym	CT	None
Ayotoya	DI	None
Azathoth	AN	None
Azira	CT	None
Aziz	M	M2
Azizam	EE	None
Azrael100	V	None
Aztec	EE	None
Azula	CV	None
AzulaCat	G	G1
B22	BW	None
B3	BV	None
BabeRuth	N	None
BaboJay	E	None
Babsiella	I	I1
BABullseye	A	A6
Babushka	AS	AS3
Baby16	A	A4
BabyBack	A	A2
BabyDaisy	EB	None
BabyDotz	EG	None
BabyGotBac	BG	None
BabyJohn	A	A3
Babyland	C	C1
BabyMoney	DT	None
BabyRay	A	A3
BabyYoda	EB	None
Bachaco	EB	None
Bachita	CQ	CQ1
Bachome	A	A11
BackstagePass	DB	None
BackyardAgain	C	C1
Backyardigan	A	A4
BaconCheese	EG	None
BaconJack	A	A1
Bactobuster	A	A2
BadAgartude	C	C1
Baddon	DE	DE1
Badfish	B	B1
Badger	A	A4
BadStone	E	None
Badulia	GE	None
Baee	B	B5
Baehexic	A	A2
BaghaKamala	K	K1
Bagrid	J	None
BaileyBlu	FP	None
Baine	EE	None
Baines	EA	EA1
BAjuniper	EB	None
BAKA	J	None
Bakery	DC	DC1
Ball	Singleton	None
Balloona	CT	None
Balomoji	E	None
Baloo	B	B3
Balsa	EA	EA1
BananaFence	C	C1
Bananafish	B	B2
Bandik	EA	EA1
Bangla1971	C	C1
BangNhom	A	A4
Banjo	B	B1
Banquo	CU	CU1
Bantam	DL	None
Baoshan	L	L2
Barb	DC	DC1
Barbarian	E	None
BarBear	EE	None
BarbieDoll	AU	AU6
Barbochs	CS	CS2
Barco	CV	None
Barebow	Singleton	None
Barkley26	G	G1
BarnCat	GB	None
Barnstormer	EH	None
Barnyard	H	H2
BaronJohn	EA	EA5
BarrelRoll	K	K1
BarretLemon	AO	AO2
Barriga	A	A1
Barroma	EK	EK2
BarrowTuph	A	A1
BarryBee	BD	BD1
Barsten	DE	DE1
Bartholomew	P	P1
BartholomewSD	BD	BD2
Bartholomune	BE	BE1
Bartimeaus	A	A4
Basato	B	B1
Basilisk	AS	AS1
Bask21	E	None
Basquiat	C	C1
Batiatus	F	F1
BatStarr	CZ	CZ1
BatteryCK	B	B1
Battleship	A	A15
Battuta	BE	BE2
Baudelaire	L	L5
Bauer	FN	None
Baumdotcom	DE	DE1
Bavilard	CT	None
BaxterFox	CZ	CZ3
BayC	BG	None
Bazzle	L	L2
BBQValindra	DB	None
Beagle	AP	AP2
Beaglebox	B	B1
Beakin	F	F1
Beans	AO	AO1
BeanWater	C	C1
BearBQ	DN	None
BeardedLady	BD	BD1
Beatrix	A	A1
BeatusComedenti	AT	None
Beaupre	AZ	AZ5
BeautPeep30	EA	EA1
Beauxregard13	A	A3
Beaver	CS	CS2
Beckerton	H	H1
Becksu	E	None
Bedetta	AS	AS2
Bee17	GE	None
BeeBee8	EA	EA1
BeeGee	CY	CY5
Beelzebub	S	None
Beem	J	None
Beemo	A	A9
Beenie	CZ	CZ4
BeesKnees	A	A1
BEEST	K	K1
Beethoven	AK	None
Beezoo	K	K1
Begonia	CV	None
Beleetus	BS	None
Belenaria	CA	None
Belfort	BK	BK1
Belieber	C	C1
Bella96	K	K1
Belladonna	K	K1
Bellis	L	L3
Bellris	A	A9
BellusTerra	A	A4
BelmontSKP	EB	None
Belphegor	DE	DE2
Belthelas	EE	None
Ben11	B	B3
Bench	E	None
BenchScraper	AY	None
Benczkowski14	CS	CS4
Benedict	A	A5
Bengal	EB	None
BengiVuitton	A	A2
BenitoAntonio	AM	None
Benjalauren	EA	EA1
Benllo	AM	None
Bennie	AK	None
BenoitCattle	CS	CS2
Benry	EJ	None
BENtherdunthat	DN	DN1
Benvolio	A	A2
Berka	FE	None
Bern	K	K1
Bernal13	T	None
Bernardo	B	B3
Bernstein	EB	None
Berrie	AZ	AZ1
Berries	CS	CS3
Beted	DQ	None
Bethlehem	A	A1
BetterKatz	DI	None
BetterYeti	DJ	None
Beuffert	BK	BK1
Bexan	A	A1
Beyoncage	DG	DG1
Bezza	C	C1
BGlluviae	K	K1
Bhageatrice	AY	None
Bhagsy	P	P1
Bialota	CZ	CZ1
BiancaTri92	A	A2
Bianmat	CS	CS3
Bibble12	AS	AS2
Bibwit	DE	DE1
Big3	A	A1
Big4	GD	GD2
BigBoyz	GH	None
BigBubba	E	None
BigCheese	L	L2
Bigchungi	A	A1
BigChungus	CT	None
BigCity	C	C1
BigDome	AO	AO2
Bigflo	A	A3
Bigfoot	A	A1
BiggityBass	DR	None
Biglebops	K	K1
BigMack	AK	None
BigMama	D	D1
BigMau	A	A1
BigNuz	P	P4
BigPaolini	A	A1
BigPhil	F	F1
BigRedClifford	EA	EA1
BigShaq	CS	CS2
Bigswole	C	C1
BilboSwaggins	E	None
BillDoor	CT	None
BillKnuckles	A	A1
BillNye	BK	BK2
BillyBobJr	CS	CS2
BillyTP	AY	None
Bilo	BI	BI2
Bimmel	BT	None
Bing	BI	BI5
BinkBonk	EE	None
Bintii	EE	None
Bioscum	BC	BC3
Biozilla	EK	EK1
BiPauneto	CR	CR4
Bipolar	F	F1
Bipolarisk	C	C1
Bipper	Y	None
Birchlyn	BE	BE2
Bircsak	A	A1
Birdfeeder	EK	EK1
BirdInFrench	EG	None
BirdsNest	B	B13
Birdsong	DN	None
BirksAndSocks	CS	CS2
BirthdayBoy	DV	None
Biscayne	EE	None
Biscute	AU	AU6
Bishoperium	B	B1
Biskit	CT	None
BiteSize	DG	DG1
Bizzy	DE	DE1
Bjanes7	CZ	CZ2
Blab	EG	None
Blackbeetle	S	None
Blackbrain	C	C1
Blackdragon	C	C1
Blackmoor	A	A4
Blackpen	DR	None
BlackSpider	FN	None
BlackStallion	B	B1
Blage	EA	EA1
Blair	AN	None
Blarby	F	None
Blesser	A	A1
Blessica	O	None
BlessJoy	A	A6
Blett	GA	None
Blexus	F	F1
BlingBling	CV	None
Blinn1	A	A6
Blino	CV	None
Blizzard	K	K1
Blocker23	B	B2
Blondies	CT	None
Bloom	FC	None
Blubba	C	C1
Blue	A	A1
Blue7	A	A6
Blueberry	CV	None
BlueBird	A	A3
BlueCrab	F	F1
Blueeyedbeauty	BK	BK1
Bluefalcon	A	A5
BlueFeather	FE	None
BlueHusk	B	B1
BlueNGold	DS	None
BlueOtter	BE	BE1
Bluephacebaby	B	B1
BluerMoon	DJ	None
BlueRugrat	EK	EK1
BlueShadow	AY	None
BluSpix	A	A1
Bmoc	BE	BE1
Bob3	A	A1
BobaPhett	F	F1
BobBob	DE	DE1
Bobby	J	None
BobbyDazzler	CA	None
BobbyK	B	B4
Bobi	F	F1
Bobquesha	K	K4
BobRoss2024	DR	None
BobsGarage	L	L2
BobSwaget	A	A2
Bock	DI	None
Bodacious	AK	None
BodEinwohner17	F	F1
Bodhi17	EE	None
Boehler	B	B1
Boersma	AQ	None
Bogg	E	None
Bogie	P	P1
BogosyJay	A	A9
Bogota	BH	None
Boiiii	K	K1
Boilgate	K	K8
Bolt007	FH	None
Bombitas	J	None
Bombshell	A	A4
BonaeVitae	EE	None
Bonamassa	A	A5
Bonanza	CA	None
Boneham	CS	CS2
Bones	A	A1
BonesMcCoy	EA	EA1
Bongo	M	M1
Bonino	EA	EA1
Bonray	C	C1
Bonum	CR	CR2
Boog	AW	None
Boohoo	A	A15
Boomer	F	F1
BoomerJR	BE	BE2
BoomRoasted	EE	None
Boopy	DS	None
BoostSeason	K	K2
Bora	O	None
Bordeaux	BE	BE2
Bosection6	N	None
Bosnia	CZ	CZ1
BossLady	AO	AO2
BotCity	DN	None
Bouchard	AU	AU2
BouleyBill	EA	EA4
BourbonZero	L	L3
Bovely	BD	BD1
Bowden	BD	BD2
Bowling	AM	None
Bowser	DB	None
Bowtie	A	A11
Boyle	B	B2
BoyNamedSue	CZ	CZ1
BPBiebs31	A	A1
BPs	G	G1
BQuat	G	G1
Brad	AV	None
Bradissa	CY	CY1
Bradley2	EE	None
Bradman	A	A2
Bradshaw	CA	None
Braelyn	BE	BE1
Brahms	EB	None
BrainDrainer	L	L4
Bramble	EF	None
Bran	EP	None
Brandonk123	DE	DE1
Brataylor	BD	BD1
Brave	JB	JB1
Braxoaddie	CR	CR6
BrayBeast	FB	None
BrazzalePHS	EC	None
Bread	C	C1
Breeniome	C	C1
Breezic	CS	CS2
Breezona	L	L2
Brent	AO	AO1
BreSam8	A	A3
Breylor17	AU	AU1
Bri160	EE	None
Briakila	B	B3
Bricole	M	M1
Bridgette	FA	None
Brilliant	B	B1
BritBrat	CY	CY2
Briton15	A	A1
Brocalys	F	F1
BRock	BS	None
BrokMonster	EE	None
Bromden	L	L4
BronxBay	AW	None
Brookers	F	F1
BroPlease	BD	BD4
Broseidon	A	A4
BrotherBLo	AK	None
BrownCNA	B	B4
Brownie5	B	B2
BruceB	G	G1
BruceLethal	BU	None
BruhMoment	AP	AP3
Bruin	E	None
Bruiser	A	A4
Brujita	I	I1
Bruns	A	A1
Brunswick	AU	AU1
Brusacoram	P	P1
Brushbloom	F	F1
BrutonGaster	CQ	CQ2
BryanRecycles	BD	BD1
Bryce	CA	None
Bryler	K	K6
Brylie	DI	None
Brynnie	AS	AS1
BubbaBear	EB	None
Bubble	CT	None
Bubbles123	F	F1
BubbleTrouble	A	A4
Bubbykins	None	None
Buck	E	None
Buckeye	B	B1
Bud	A	A11
Budski	DN	None
Bugatti	A	A3
Bugg	DJ	None
Buggaboo	CR	CR2
BugsBunny	E	None
Bugsy	A	A2
Buldak	EB	None
Bullzi2019	EE	None
Bumble	FH	None
Bumblebee11	A	A4
Bunker	DB	None
Bunnies	P	P1
Bunnybear	CZ	None
Burger	A	A4
Burgy	EE	None
Burley	DJ	None
Burnsey	CT	None
Burr	B	B1
Burritobowl	EB	None
Burro	EM	EM1
Burrough	C	C1
Burton	A	A1
BurtonThePup	EE	None
Burwell21	F	F1
Busephilis	EC	None
Bush	GA	None
Bustleton	EA	EA4
Butterball	CS	CS2
Butters	N	None
Butterscotch	D	D1
Button	CT	None
Buttons	A	A1
Buttrmlkdreams	CT	None
BuzzBuzz	A	A3
BuzzLyseyear	F	F1
Bxb1	A	A1
Bxz1	C	C1
Bxz2	A	A3
ByChance	F	F1
Byougenkin	F	F1
Byron23	EA	EA1
C3PO	EN	None
CabbageMan	FE	None
Cabrinians	F	F1
Cactojaque	C	C1
Cactus	E	None
CactusJack	P	P1
CactusRose	A	A1
Cadmus	BE	BE1
Caelakin	A	A4
Caelum	BD	BD2
Cafasso	DZ	None
CaiB	DR	None
Cain	K	K6
Caitlin	A	A8
Calamitous	B	B2
Cali	C	C1
Caliburn	BD	BD1
Calix	EA	EA1
CallaLilly	K	K1
CallieOMalley	AK	None
CallinAllBarbz	FP	None
Calm	L	L1
Calvinny	A	A3
CalWood4100	FH	None
Camara	AS	AS3
Cambiare	G	G2
Camerico	DF	DF4
Camille	EL	None
CamL	B	B1
Camperdownii	A	A4
CampRoach	B	B1
Camri	G	G1
Camster	P	P1
CandC	EG	None
Candle	R	None
Candra	A	A6
Cane17	C	C1
CanesSauce	CT	None
Cannibal	B	B1
Canowicakte	AK	None
Cantare	Singleton	None
Capablanca	C	C1
CapnMurica	AU	AU1
Cappuccino	AZ	AZ5
Caprice	S	None
Capricorn	K	K1
CaptainKirk2	CV	None
CaptainRex	EA	EA5
CaptainTrips	F	F1
Captrips	DJ	None
Capybara	DJ	None
CaramelLatte	CT	None
Caravan	C	C1
Caraxes	A	A2
Carcharodon	N	None
Cardigan	DD	None
CarefulCloud	ER	None
CarisSwetlik	EA	EA1
Carlyle	A	A1
CarolAnn	CV	None
Caron	EH	None
Carostasia	EA	EA10
Carpal	AK	None
Carrillo	GA	None
Carsonalex	CT	None
Carthage	B	B1
Casablancas	ED	ED2
Casbah	B	B3
CaseJules	K	K1
Casend	EG	None
Casey	EA	EA3
Cashington	EB	None
Cashline	CY	CY6
Casino	EM	EM1
Caspiboi	B	B1
Casserole	AV	None
Cassia	AZ	AZ1
CassieYates	G	G1
Cassita	GB	None
CastorTray	AU	AU1
Catalina	A	A9
Catdawg	O	None
Catera	C	C1
Caterpillar	AU	AU4
Catfish	CU	CU5
CathyBurgh	CS	CS2
Causa	AI	None
Caviar	A	A3
Cayde6	EE	None
Cazares	EE	None
Cborch11	H	H1
Cece	GD	GD3
Cedasite	G	G1
CeilingFan	BE	BE2
Celaena	EB	None
Celery	BD	BD3
Celeste	BD	BD1
Celestialunch	A	A9
Celia	BD	BD6
Cen1621	EH	None
Centaur	A	A2
CentreCat	A	A4
Cepens	W	None
Cerasum	F	F1
Cerulean	A	A4
CGermain	AN	None
ChaChing	B	B3
ChadMasterC	DE	DE1
Chadwick	A	A5
Chaelin	B	B1
Chaewon	BK	BK2
Chah	B	B1
Chako	EA	EA1
Chalmers	B	B3
ChampagnePapi	A	A4
Chamuel	EA	EA1
Chanagan	A	A1
Chance64	G	G1
Chancellor	K	K4
Chandler	B	B3
Changeling	A	A2
Chaph	A	A4
Charbie	EE	None
Chargerpower	A	A22
Chargie21	C	C1
Charianelly	CS	CS3
Charles1	B	B1
Charlie	N	None
CharlieB	C	C1
CharlieGBrown	B	B1
CharlottesWeb	DR	None
Charm	A	A9
Charming	DE	DE1
Chartreuse	A	A6
Chaser	L	L4
Chatham	EE	None
Chavito	K	K1
ChaylaJr	C	C1
Che12	A	A2
Che8	F	F1
Che9c	I	I2
Che9d	F	F2
Cheesecake	EE	None
CheeseDanish	FE	None
Cheesepuff	F	F1
CheeseTouch	DN	DN1
Cheesy	AM	None
CheetO	B	B1
Cheeto1	EA	EA9
Cheetobro	K	K4
CheetoDust	K	K1
Chelms	CS	CS2
Chentzyk	B	B3
Chepli	EA	EA6
Cher	B	B1
CherryBlossom	BI	BI1
Cherrybomb426	G	G1
CherryCola	DC	DC1
CherryonLim	CT	None
CherryTomatoes	DO	None
Chestnut	AN	None
Chevrolet	F	F1
Chewbacca	N	None
ChewChew	AK	None
ChewyVIII	Singleton	None
Chickaboom	AS	AS1
Chickadee	DE	DE3
ChickenDinner	F	F1
ChickenKing	EA	EA9
ChickenPhender	C	C1
ChickenTender	CT	None
ChickyNuggy	DJ	None
Chidiebere	DQ	None
Chikenjars	DJ	None
ChikPic	EA	EA2
Childish	B	B1
ChiliPepper	EB	None
Chill	D	D1
Chilliams	FC	None
Chipette	B	B1
ChipMunk	A	A2
Chipper1996	AR	None
Chiqui	A	A3
ChisanaKitsune	DQ	None
Chivey	EF	None
Chlochlo	AU	AU2
Chocolat	AR	None
ChocoMunchkin	CT	None
Cholula	AK	None
Chomp	C	C1
Chop	DI	None
Chorkpop	B	B1
ChosenOne	E	None
ChotaBhai	E	None
Chridison	AK	None
Chris	K	K1
ChrisnMich	B	B4
Christian	AK	None
Christoph	EA	EA1
Chubster	AR	None
ChuckDuck	FA	None
Chuckly	F	F1
Chucky	BD	BD1
Chunky	B	B1
Chupacabra	A	A10
Chute	B	B1
ChutneyChips	L	L4
Chymera	Singleton	None
Ciao	A	A1
Cicada	EJ	None
CicholasNage	L	L1
Cici	A	A4
Ciel	EE	None
Cindaradix	A	A4
CindyLou	C	C1
Cinna	EI	None
CinnamonToast	CS	CS2
Cintron	A	A4
Circinus	BK	BK2
Circuit	FH	None
Circum	AM	None
Citius	A	A4
Citrus	DJ	None
Cjw1	E	None
ClamChowder	DC	DC1
Clammy	A	A3
Clancy	EA	EA1
Clap	CZ	CZ2
Clarenza	A	A4
Clark	CZ	CZ4
Clarkson	S	None
Claus	L	L2
Clautastrophe	L	L3
Clawz	CP	None
Clayda5	EB	None
ClearAsMud	EC	None
CLED96	G	G1
Cleo	CT	None
CliffHanger	EB	None
Clifton	F	F1
Clipper	K	K1
Clock	EA	EA5
CloudWang3	A	A6
Cloudyecho	G	G3
CloverMinnie	DR	None
Clown	DC	DC2
Clownery	EE	None
ClubL	CQ	CQ1
ClubPenguin	BI	BI7
Cobra	B	B1
Coco12	F	F1
Cocoaberry	A	A4
CocoaPuff	CT	None
CocoCinnamon	FO	None
Coeur	CW	CW2
Coffee	B	B2
CoffeeBean	CR	CR6
CogOmlette	A	A9
ColaCorta	EA	EA2
Colbert	B	B1
Colbster	A	A3
Coldpizza	DR	None
ColdSoup	CP	None
Cole	FF	None
Coleslaw	G	G1
Coletti	B	B1
Colin	A	A2
Collard	K	K5
Colleen	EO	None
Colossa	KA	None
Colt	C	C1
Coltrane	EB	None
Colucci	AR	None
Colusalem	AS	AS2
Command613	E	None
Commandaria	CR	CR2
Commander	A	A4
Commonplace	JD	None
Community	AZ	AZ1
Compostia	B	B3
Comrade	BK	BK1
Conan	BD	BD3
Conboy	AR	None
ConceptII	A	A1
Concombre	C	C1
Concrete	EE	None
Confidence	CY	CY1
Conley	DJ	None
Connomayer	A	A4
Conquerage	A	A9
Conspiracy	A	A5
Constance	FA	None
Constella	J	None
Contagion	E	None
Convict	EA	EA1
Coog	A	A5
Coogler	BE	BE1
CookieBear	AY	None
CookieDog	GA	None
Cookiedough	A	A6
Cookies	E	None
CoolCookie	EF	None
Cooper	B	B4
Copper	AN	None
Coral	AS	AS2
Corazon	S	None
Corgi	FE	None
Coriander	DB	None
Corium	F	F1
Corn21	EK	EK1
Cornbread	B	B1
Corndog	O	None
Cornie	F	F5
Cornobble	B	B1
Cornucopia	F	F1
Corofin	B	B3
Correa	AM	None
Corvo	A	A1
CosmicSans	CA	None
Cosmo	V	None
Cosmolli16	B	B1
Cota	BU	None
Cote	AS	AS2
Count	EL	None
Courthouse	J	None
Courtney3	AN	None
CoveyB	DC	DC1
Cozz	CT	None
Cracklewink	Y	None
Craff	B	B1
Cranjis	EC	None
Crater	DN	DN3
CrazyRich	EC	None
CRB1	A	A2
CRB2	B	B9
Crespo	G	G1
Cressida	EI	None
Crestdrop	EF	None
Crete	CS	CS2
CREW	K	K1
Crewmate	AZ	AZ1
CricKo	BI	BI4
CrimD	K	K1
Crisis	EC	None
Crispicous1	A	A1
CristinaYang	AK	None
Crocheter	DJ	None
Crosby	BH	None
Cross	BE	BE1
Crossroads	L	L2
Crownjwl	B	B1
CroZenni	EB	None
Crucio	A	A2
Cruella	EN	None
Crumble	F	F1
CrunchyBoi	EK	EK1
CrystalP	E	None
Cuco	A	A5
Cucurbita	CQ	CQ1
Cueylyss	A	A1
Cuke	AC	None
Cullens	A	A3
Culver	CQ	CQ1
Cumberbatch	BP	None
CupcakePrincess	EB	None
Curie	GI	None
Curiosium	K	K1
CurlyFries	CF	None
Cursive	BE	BE1
Cyan	AZ	AZ1
Cybele	EF	None
Cygnet	AS	AS2
Cynthia	CZ	CZ2
CyranoPS	ER	None
Czyszczon1	E	None
D29	A	A2
D32	A	A2
DaddyDaniels	B	B1
Daddyjeff	JA	None
DaddyRickover	F	F1
Dadosky	K	K5
Daegal	Q	None
Daenerys	F	F1
Daffodil	C	C1
Daffy	B	B1
DaftyDuck	EE	None
DaHudson	A	A3
Daiboju	AK	None
Daikon	E	None
Daishi	A	A3
Daisy	B	B3
Daka	B	B1
Dakiti	CS	CS2
DalanDe	DQ	None
Dalilpop	CR	CR1
Dallas	J	None
Dalmatian	A	A2
Dalmuri	K	K1
Damascus	EL	None
Damien	H	H1
Damp	CS	CS3
DanBing	L	L2
Dancer	DJ	None
Dandelion	C	C1
Danforth	A	A8
DanHam62	AS	AS3
DanielleIgnace	AT	None
Danimal	EE	None
Danno	EE	None
DannyDe	EF	None
DanSyl44	K	K4
Dante	F	F1
Danyall	DC	DC1
Danzina	BD	BD1
Daob	AS	AS2
Darby	AU	AU1
Dardanus	CU	CU3
DaRealMyers	BC	BC1
Daredevil	DL	None
Darionha	G	G1
Darko	C	C1
Darolandstone	BC	BC2
Darrell	A	A9
DarthP	K	K6
DarthPhader	A	A12
Dartin	K	K1
Darwin	EN	None
Dashyla	EK	EK1
DatBoi	DL	None
Dati	B	B1
Dattran	BD	BD1
Datway	A	A4
Daubenski	BE	BE1
Daudau	BD	BD2
Dauntless	EF	None
Dave	EA	EA1
Davielle	BE	BE1
DaviePasture	DV	None
DaVinci	A	A6
DaWorst	F	F1
DBQu4n	A	A2
DD5	A	A1
DeadP	F	F1
Deano	A	A4
Deb65	F	F1
Deby	K	K1
Decurro	AN	None
DeejaClivia	C	C1
Deenasa	B	B3
DeepSoil15	Q	None
DeerParkTS	A	A2
DeGene	DJ	None
DejaVu	ED	ED1
DekHockey33	A	A15
DelaGarza	GF	None
Delian	CV	None
Delilah	C	C1
Deloris	A	A2
Delphidian	EA	EA1
Delrey21	DE	DE4
DelRio	DI	None
DelRivs	B	B1
Delton	D	D1
Delylah	C	C1
Demodog	C	C1
Demosthenes	CS	CS4
Demsculpinboyz	F	F2
Demure	DJ	None
Den3	EA	EA1
Denise	CZ	CZ5
Dennebes	BF	None
Derek	C	C1
Derg	DE	DE1
Derpp	B	B1
DesireeRose	GE	None
Destructrice	BF	None
Devera	K	K1
DevitoJr	AU	AU1
Devonte	B	B3
Dewayne	AN	None
Dewdrop	GC	None
Dewey	Q	None
Dexdert	DE	DE3
Dexers	BD	BD3
Dexes	A	A1
DHan	L	L2
Dhanush	A	A4
Diabla	CS	CS2
Dialga	DJ	None
Diane	BD	BD2
Dice	B	B1
DickRichards	EB	None
Didgeridoo	EB	None
Dieselweasel	A	A3
Dietrick	C	C1
DigitDog	B	B5
Dignity	A	A2
DillTech15	F	F1
DillyDally	Singleton	None
Diminimus	M	M1
Dina	EP	None
Ding	AY	None
Dinger	CA	None
Dingo	B	B1
Dino	AK	None
DinoDaryn	CU	CU1
Dione	B	B1
DirkDirk	L	L1
Dirtdigger	FF	None
Dirtfootball	DM	None
DirtJuice	B	B1
DirtMcgirt	F	F1
DirtMonster	C	C1
DirtPie	EE	None
DirtyBoi	DB	None
DirtyBubble	EB	None
DirtyDunning	A	A4
Discoknowium	A	A5
DismalFunk	K	K2
DismalStressor	K	K2
Dismas	EB	None
Dixon	A	A8
DizzyRudy	EL	None
Djokovic	DG	DG1
Djungelskog	AW	None
DLane	F	F1
Dmitri	DB	None
DMoney	G	G1
DmpstrDiver	J	None
DobbysSock	CZ	CZ4
DocB7	Singleton	None
DocMcStuffins	F	F1
DoctorDiddles	E	None
DoctorFroggo	DE	DE4
DoctorPepper	AW	None
Doddsville	B	B1
Dodo	GD	GD1
DoesntMatter	B	B1
Dogfish	DT	None
Doggs	DB	None
DogYard	AP	AP2
Dole	K	K1
Dolores	CZ	CZ4
Domi	C	C1
DonaldDuck	EG	None
Donatella	FF	None
Dongwon	EE	None
Donkey	AZ	AZ5
Donkeykong	F	F1
DonkeyMan	DY	None
Donny	B	B5
Donovan	P	P1
DonSanchon	B	B1
DontArgue	A	A10
DonTron	CP	None
Doobus	EB	None
Dooby	EE	None
DoobyDoo	DV	None
Doom	A	A1
Doomphist	F	F1
DoRead	F	F1
Dori	AD	None
Dorin	CG	None
Dorito	CZ	CZ4
Dorothea	A	A6
Dorothy	F	F1
DosHalletts	F	F1
Dothraki	EA	EA1
DoTi	EM	EM1
DotProduct	F	F1
Doucette	BW	None
Doug	F	F1
Douge	L	L4
Douggie	EE	None
Doughnut	K	K2
Douzhi	L	L4
Dove	J	None
Doxi13	BI	BI2
Drago	F	F1
Drake55	A	A2
Drake94	A	A10
Drazdys	C	C1
DRBy19	F	F1
DrDrey	E	None
Dre3	CT	None
Dreamboat	A	A1
DreamCatcher	A	A1
DreamTeam	AK	None
DreamTeam1	A	A9
DrFeelGood	A	A1
DrGrey	BI	BI1
DrHayes	K	K1
DrLupo	H	H2
DrManhattan	AZ	AZ1
DroogsArmy	A	A7
DropBear	A	A3
Dropshot	GA	None
DrParker	BU	None
DrPhinkDaddy	C	C1
DrRobert	AK	None
DrSeegs	L	L2
DrSierra	AZ	AZ1
Druantia	A	A4
Dryad	BN	None
DrYang	AR	None
DS6A	Singleton	None
DTDevon	C	C1
Dublin	A	A5
Dubu	BJ	None
DuchessDung	B	B1
DudeLittle	A	A2
Duffington	DJ	None
Duggie	B	B1
Duke13	J	None
Dulcie	A	A1
Dulcita	M	M1
Dumbo	E	None
DumpQuist	EK	EK1
DumpsterDude	DW	None
DumpTruck	DV	None
Dunamis	FD	None
DuncansLeg	L	L3
DunneganBoMo	FC	None
Duocatuli	EA	EA1
Duplicity	N	None
Duplo	A	A2
Durfee	K	K1
Durga	B	B1
Dusk	E	None
Dussy	A	A1
Dusty	CQ	CQ1
DustyDino	ED	ED2
DustyMartin	A	A10
Dwayne	BD	BD1
Dylan	O	None
Dynamite	AM	None
Dynamix	A	A1
Dynamo	P	P1
DyoEdafos	L	L4
E1	BV	None
E3	Singleton	None
E6	BW	None
Eagle	A	A4
EagleEye	A	A16
Eaglehorse	B	B2
Eaglepride	A	A10
Eapen	A	A4
EarickHC	EC	None
Easley	CZ	CZ4
Eastland	BP	None
EastView9101	B	B5
EastWest	AO	None
Easy2Say	E	None
EasyJones	C	C1
Ebert	CZ	CZ2
Ebony	A	A11
ECartman	G	G1
Echild	A	A2
Ecliptus	DN	None
Eddasa	BD	BD1
Eddiemania	DJ	None
EdElric	EE	None
Eden	EB	None
EdgarPoe	AR	None
Edison31	A	A10
EdmundFerry	DE	DE3
Edmundo	AL	None
EdnaMode	CZ	CZ2
EdogawaKiddo	A	A9
Edtherson	A	A1
Edugator	K	K5
Eesa	AS	AS1
Eevee	JA	None
Efeko	EE	None
Efra2	K	K1
Egad	AW	None
Eggsie	CS	CS2
EggyFarm	C	C1
Egi03	DC	DC1
EGole	BE	BE1
EGUnicorn	N	None
EhyElimayoE	BM	None
Eidsmoe	A	A9
Eightball	EE	None
Eileen	FA	None
Ein37	Q	None
Eish	F	F1
Ejemplo	BD	BD1
Ejimix	J	None
Ekdilam	K	K6
Ekhein	CS	CS2
Ekko14	EE	None
Eklok	BP	None
ELB20	BD	BD2
EleanorGeorge	F	F1
ElectricPheel	AN	None
ELee24	EE	None
Elener	Singleton	None
ElephantMan	AU	AU1
Elephantoon	A	A9
Eleri	EA	EA2
Elesar	FF	None
Elezi	AZ	AZ1
Elfy	FP	None
ElGato	BD	BD3
Elinal	CT	None
Eliott	CT	None
Elite2014	E	None
ElJefes	CT	None
Elkhorn	AN	None
Ellewin	FC	None
Ellie	K	K6
Ellison17	JB	JB1
Ellson	L	L3
Elmer	BE	BE2
Elph10	E	None
Elsa	AM	None
Elspeth	EE	None
ElTiger69	A	A5
Elva	EB	None
Elver	FK	None
ElvisPhasley	B	B1
Emaanora	BD	BD1
Emalyn	CT	None
Emerson	K	K1
Emianna	CR	CR2
EmiMonkey	F	F1
Emiris	B	B1
EmiRose	Singleton	None
Emma	F	F1
Emma1919	BK	BK1
EmmaElysia	C	C1
Emmaloid	F	F1
Emmetator	FC	None
Emmina	E	None
EmoNemo	DQ	None
EMoore	DE	DE2
Emotion	AZ	AZ4
Emperor	DM	None
Empress	F	F1
EmpTee	B	B1
EMsquaredA	CY	CY1
EmToTheThree	C	C1
EmyBug	A	A9
EnalisNailo	CY	CY1
Enby	F	F1
Enceladus	L	L1
EndAve	DJ	None
Endor	EA	EA1
Engineer	CQ	CQ1
EniyanLRS	V	None
Enkosi	K	K1
Ennea	CR	CR3
Enochoraptor	BU	None
EnochSoames	BD	BD1
Enoki	BU	None
Enygma	BE	BE2
EnzoK	A	A1
Epah	B	B4
EpicDab	DM	None
EpicPhail	A	A3
Eponine	K	K4
Epsocamisio	A	A15
Equemioh13	A	A2
Eradicator	F	F1
Eraser	AZ	AZ1
Erdmann	C	C1
Eremos	B	B1
Erenyeager	ED	ED2
EricB	A	A6
EricMillard	J	None
Erik	CA	None
Erin	EE	None
Eris	A	A4
Erk16	D	D1
Erla	EA	EA1
ErnieJ	C	C1
Eros	A	A4
Erudite	EF	None
Erutan	DV	None
Esketit	BI	BI1
Esperer	BD	BD1
Espica	CA	None
Espinosa	EA	EA1
Espresso	A	A1
Essence	C	C1
Estave1	F	F1
EstebanJulior	AK	None
Estes	M	M2
ET08	C	C1
Et2Brutus	A	A11
Etaye	B	B1
Etna	EA	EA1
Etoile	P	P1
Etta	EA	EA1
Eudoria	CZ	CZ1
EugeneKrabs	EK	None
Eugenia	B	B1
Eula	EB	None
Eunoia	AK	None
Euphoria	A	A1
Euratis	BB	BB1
Eureka	E	None
Eurydice	A	A4
Evaa	DR	None
Evamon	DC	DC1
Evanesce	Q	None
Evcara	GI	None
EvenBluerMoon	FO	None
EvePickles	AY	None
EverythinBagel	EG	None
Eviarto	CZ	CZ1
EvilGenius	A	A2
Evy	BE	BE1
Ewald	DT	None
Ewok	C	C1
Exiguo	CS	CS2
Exile	AZ	AZ6
Expelliarmus	A	A8
Exploradora	EA	EA1
ExplosioNervosa	A	A9
Eyeball	A	A1
Eyes	DB	None
Eyre	Singleton	None
EZMoney23	A	A2
Fabian	BF	None
Fairfaxidum	CV	None
FairyPath	E	None
Fairywren	JB	JB1
Faith1	L	L2
Faith5x5	CZ	CZ6
Faiyaz	Y	None
Faja	AY	None
Fajezeel	A	A1
Fameo	A	A2
Familton	O	None
Fanaw	B	B4
Fancypants	F	F1
Fang	B	B1
Farber	A	A3
Farewell	AF	None
FarmerDoug	EA	EA1
FarmResident	L	L4
Fascinus	A	A1
Fastidio	F	F1
FatCactus	A	A20
Faust	BK	BK1
Fayely	A	A9
Faze9	B	B2
Fazel	DJ	None
Feastonyeet	CT	None
Fede	EK	EK2
Fefferhead	K	K6
FeliMaine	S	None
FelixAlejandro	CS	CS2
Fenn	A	A1
Fenry	CV	None
Fernando	A	A3
Feyre	K	K5
FF47	AB	None
Fibonacci	A	A11
FidgetOrca	BI	BI1
Figliar	DJ	None
Figueroism	EA	EA1
Filch	E	None
Filuzino	F	F1
Finalfrontier	EB	None
Finch	Singleton	None
Findley	K	K2
Finemlucis	L	L2
Fingolfin	AS	AS3
Finkle	Singleton	None
Finnry	L	L3
Finny	EA	EA2
Fionnbharth	K	K4
Fireball	DC	DC1
FireCastle	EJ	None
Firecracker	O	None
Firehouse51	F	F1
Fireman	EC	None
FireRed	E	None
FiringLine	A	A2
First	A	A2
FirstPlacePfu	P	P1
Fishburne	P	P1
Fitzgerald	DE	DE1
FiveHead	AZ	AZ4
Fizzles	EG	None
Flabslab	C	C1
FlagStaff	G	G2
Flakey	CS	CS2
FlameThrower	EB	None
Flapper	CR	CR1
Flare16	A	A2
Flashwig	ER	None
Flathead	F	F1
Flatwoods	DE	DE1
Flaverint	A	A11
Float294	CR	CR3
Floof	EH	None
Floral	CY	CY1
Florean	A	A4
Florinda	F	F1
FlowerPower	BF	None
Fludd	C	C1
FluffyNinja	B	B1
Fluke	AK	None
Flux	A	A4
FlyCatcher	A	A7
FlyingTortilla	DQ	None
Flypotenuse	E	None
FoghornLeghorn	E	None
Fongie	C	C1
Footloose	Singleton	None
ForDig	B	B6
ForesterFrank	A	A2
Forge	Q	None
ForGetIt	A	A5
Fork	ED	ED2
Forrest	BK	BK1
Forrestell	AP	AP2
Forsytheast	A	A1
FortCran	DJ	None
Forthebois	BO	None
Fortunato	B	B4
Forza	DS	None
FosterFrank	FA	None
Fosterous	DE	DE1
FoulBall	O	None
Fowlmouth	AC	None
Foxboro	CR	CR2
FoxtrotP1	C	C1
Fozzie	B	B1
Francesca	CG	None
Francis47	A	A1
Francob	BK	BK1
Francois	DI	None
FrankDeliGuy	EG	None
Frankenweenie	BM	None
Frankicide	B	B1
Frankie	F	F1
Franklin22	EB	None
Fransoyer	EG	None
Franzy	AO	AO1
FrayBell	C	C1
FreakyGoo	M	M1
Fred313	A	A3
FreddieHg	EF	None
FreddyB	F	F1
Frederick	B	B4
Fregley	EG	None
FremontTroll	B	B1
FrenchFry	B	B2
Fresco	DR	None
Freya	B	B1
FriarPreacher	B	B1
Fribs8	CT	None
Frickyeah	DN	DN1
Fringe	B	B1
Frizzle	DA	None
FrodoSwaggins	BI	BI1
FroggyToad	CZ	CZ2
Froghopper	A	A1
Frokostdame	CV	None
FromIndy	BI	BI4
Frosty24	G	G1
Fruitloop	F	F1
FrumpyGal	BP	None
Fryberger	DP	None
FudgeTart	C	C1
FuegoCuervo	DE	DE1
FugateOSU	B	B1
Fugax	DC	DC1
Fulbright	N	None
Fulcrum	DV	None
Fullmetal	EK	EK2
Fulton	EA	EA5
Funsized	B	B9
Funston	A	A4
Fury	CR	CR5
Fushigi	A	A1
FuzzBuster	Singleton	None
G4	BW	None
Gabbspett	EE	None
Gabriel	C	C1
Gabriela	L	L2
Gachnar	A	A1
Gack	EB	None
Gadjet	B	B3
Gadost	A	A4
Gaea	DE	DE1
GaeCeo	EA	EA9
Gage	E	None
GageAP	A	A1
Gaia	X	None
Gail	A	A14
GAL1	Singleton	None
Galactic	F	F1
Galactica	BQ	None
GalacticEye	CS	CS3
Galadriel	DE	DE1
Galaxy	AS	AS1
GaloreK	P	P1
Gambino	CV	None
Gambol	AZ	AZ5
Gamgam	C	C1
Ganandorf	EC	None
Gancho	Q	None
Gandalf20	A	A1
Gandalph	F	F1
Gandionco	FK	None
GantcherGoblin	AU	AU6
Ganymede	K	K1
Garak	A	A6
Gardann	L	L2
GardenB	EA	EA1
GardenSalsa	M	M2
GardenState	EH	None
Gardevoir	EE	None
Gareth	B	B1
Garey24	EA	EA1
Gargoyle	EA	EA1
Garnacho	BS	None
Gator	E	None
Gattaca	S	None
GaugeLDP	A	A2
Gavriela	P	P1
Gazebo	EG	None
GEazy	DB	None
Geeche	CQ	CQ1
Gelo	EA	EA1
GemG	CZ	CZ2
Gemini	E	None
Gemma	A	A3
Genamy16	DV	None
GeneCoco	B	B1
GenevaB15	M	M2
Gengar	K	K5
Genie2	BE	BE2
Geodirt	DE	DE1
George	A	A5
Georgie2	A	A2
Geostin	BF	None
Geraldini	K	K1
Geralt	F	F1
Gershwin	EA	EA1
Gervas	B	B3
Getalong	DN	DN1
Gex	N	None
Gezellig	DC	DC1
Ghobes	DA	None
Ghost	C	C1
Ghoulboy	A	A5
Giantsbane	AU	AU2
Gibbi	BE	BE2
Gibbin	DV	None
Gibbles	CX	None
Gibbous	CT	None
Gibson	BN	None
Gideon	G	G1
GigiOuiOui	F	F1
GiJojo	BS	None
GiKK	CT	None
Gilberta	A	A11
Gilda	EF	None
Giles	Q	None
Gilgamesh	Singleton	None
Gill	DJ	None
Gillker	EE	None
Gilson	BK	BK1
Gina	EC	None
Gingerbug	GF	None
GingkoMaracino	A	A3
GinPorsche	B	B4
Giorgio	AZ	AZ5
Girafales	F	F1
Giraffe	B	B1
GirlDinner	BD	BD2
GirlPower	BI	BI1
Giroux	A	A3
Girr	F	F1
Gisselle	AK	None
Giuseppe	D	D1
Gizermo	CZ	CZ2
Gizmo	C	C1
Gladiator	A	A6
Glamour	EA	EA2
Glaske	P	P1
Glaske16	M	M1
Glass	B	B2
GlenHope	B	B3
Glenn	AK	None
Glexan	E	None
Globfish	AY	None
GlobiWarming	FA	None
Glorp	EC	None
Glotell	AS	AS3
Glubnar	B	B3
GlutenPhree	C	C1
GMA1	Singleton	None
GMA2	DS	None
GMA3	DF	DF2
GMA4	Singleton	None
GMA5	CW	CW2
GMA6	DQ	None
GMA7	CS	CS1
Gmala1	DF	DF1
GMonster	A	A1
GOATification	DV	None
GoblinVoyage	BI	BI2
Goby	BD	BD1
GoCrazy	AM	None
Godfather	EE	None
Godines	B	B2
GodonK	DK	None
GodPhather	W	None
Godpower	BD	BD1
Goib	CU	CU1
Goku	E	None
GoldDust	FL	None
Golden	EA	EA4
GoldenAsh	G	G1
GoldenBlanche	EE	None
GoldenEssence	FC	None
GoldenSpark	E	None
GoldHunter	CT	None
Goldilocks	E	None
Gollum	CA	None
Gomashi	G	G1
Gompeii16	A	A1
Gonephishing	J	None
GooberAzure	E	None
Goobery	EE	None
Goodgraces	FD	None
GoodLuckBabe	FF	None
Goodman	EJ	None
GoongGoong	S	None
Goose	A	A10
Gophee	B	B1
GordDuk1	DF	DF1
Gordon	AU	AU1
GordTnk2	DF	DF1
Gorge	F	F1
Gorgeous	AQ	None
Gorko	CS	CS2
Gorpy	AY	None
GourdThymes	CS	CS2
Graduation	A	A1
Grand2040	B	B1
GrandSlam	DI	None
Grassboy	EG	None
Grasshills	C	C1
Gratitude	A	A2
Gravaillia	Q	None
Gravel	AS	AS1
GravityBall	AO	AO2
Gravy	DJ	None
Gray	DQ	None
Grayson	CB	None
GreaseLightnin	P	P1
GrecoEtereo	A	A1
GreedyLawyer	A	A6
Greely	C	C2
Greenbelt	BN	None
GreenHearts	AK	None
Greenhouse	AK	None
GreenIvy	EA	EA5
GreenWeasel	BD	BD4
Greg	A	A1
Grekaycon	AO	AO2
Gremlin23	BF	None
Gretchen	EH	None
GretelLyn	DV	None
Greys	EA	EA1
Grif	A	A3
Grimmer	F	F1
Grizzly	G	G1
GrootJr	CR	CR2
Grotle	JB	JB1
Groundhog	A	A8
Groupthink	A	A3
GRU1	CR	CR1
GRU3	CW	CW2
Grub	A	A3
Grum1	A	A3
Grumio	CP	None
Grungle	C	C1
Gruunaga	A	A6
Gshelby23	EM	EM1
Gsput1	CU	CU2
GTE2	CT	None
GTE5	CR	CR1
GTE6	DE	DE3
GTE7	CS	CS1
GTE8	CR	CR2
GtownJaz	A	A3
Guacamole	CV	None
Guanica15	K	K1
Gubbabump	EA	EA1
Gudmit	Singleton	None
Guetzie	EA	EA4
Guey18	DP	None
Guillaume	CS	CS3
Guillsminger	K	K5
Guinevere	FF	None
Gumball	D	D1
GUmbie	F	F1
Gumpizza	AZ	AZ5
Guntur	AN	None
GUPitcher	FJ	None
Guppsters	F	F1
GurgleFerb	AV	None
Gusanita	FF	None
Gusicorn	DJ	None
Gustav	CD	None
Gustavo	DE	DE1
GuuelaD	L	L2
Guwapp	C	C1
GuyFagieri	CR	CR6
Guzman	GA	None
Gwendoluna	A	A1
Gwennie	A	A3
Gwennie1	B	B1
Gwilliam	B	B1
Gyarad	B	B1
Gyzlar	A	A1
Hades	F	F1
Hadrien	Q	None
Hafay	L	L2
Hager	EF	None
Hail	Q	None
Hail2Pitt	CS	CS3
Haimas	B	B1
HairyMan	EA	EA10
Haizum	BD	BD2
Haleema	B	B1
Halena	L	L1
Haley23	CZ	CZ2
Halfpint	B	B3
Halldule	C	C1
Halley	J	None
Halloweekend	FF	None
Hally898	B	B4
Halo	G	G1
Halo3	DC	DC1
Halsey	AZ	AZ5
HamCheese	AS	AS3
Hami1	A	A1
Hamish	B	B1
Hamlet	EA	EA1
Hammer	A	A6
Hammy	K	K6
Hamood	DI	None
HamSlice	A	A4
Hamulus	F	F1
Hanako	N	None
Hanem	DQ	None
Hangman	B	B4
HangryHippo	BE	BE1
Hank144	BD	BD2
HanKaySha	E	None
Hankly	AM	None
HankSprout	EA	EA1
Hannabella	EM	EM1
Hannaconda	J	None
HannahD	DB	None
HannahPhantana	AS	AS2
Hanray	A	A9
Hans	DE	DE2
HanShotFirst	A	A1
HanSolo	EA	EA1
Happiness	A	A4
Harambe	CS	CS3
Harella	E	None
Harlequin	CA	None
Harley	F	F1
HarperAnne	EE	None
HarryHoudini	A	A2
HarryOW	A	A1
Hartsy	B	B1
Harvey	B	B1
HarveySr	B	B3
Hashim76	B	B13
HashRod	A	A3
Hasitha	EA	EA5
HaugeAnator	BF	None
Haunter	EF	None
HaveUMetTed	A	A3
Hawkeye	D	D2
HayZem	CS	CS1
HazuAndZazu	BI	BI1
HeadMave	EE	None
HeadNerd	AK	None
Heath	B	B4
Heathcliff	B	B3
Heathen	A	A3
Heather	BB	BB2
Hedgerow	B	B2
Hedwig	DB	None
HedwigODU	K	K1
Heffalump	A	A2
Heftyboy	K	K5
Hegedechwinu	F	F1
Heinz	DY	None
Heisenberger	AM	None
Held	B	B1
HelDan	A	A3
Heliosoles	A	A3
Hello	CS	CS3
Helmet	A	A6
Helpful	D	D1
Hendrix	GC	None
Henoccus	BH	None
Henry	E	None
HenryJackson	B	B1
Herb	AK	None
HerbBucket	AW	None
Herbertwm	A	A2
Hercules11	A	A3
HerculesXL	EA	EA11
Hermeonysus	EC	None
Hermia	A	A1
HermioneGrange	A	A1
Hernandez44	EE	None
Herod	CZ	CZ1
Hertubise	B	B1
Hestia	AY	None
Hetaeria	B	B1
Hexamo	A	A6
Hexbug	CT	None
Heylee	AQ	None
HFrancette	BP	None
HH92	Q	None
Hibiscus	DY	None
Hiddenleaf	EF	None
Highbury	E	None
HighStump	B	B1
Hillester	AY	None
Hilltopfarm	Y	None
HINdeR	A	A7
Hippo	BD	BD1
HippoHollow	A	A2
HippoPololi	CT	None
Hirko	FL	None
Hiro	CA	None
HitchHiker	EK	EK1
Hitter	CV	None
Hiyaa	BQ	None
Hlubikazi	F	F1
Hocus	B	B1
HokkenD	J	None
Holeinone	B	B2
Holex	A	A9
Holli	A	A4
Holliday	DN	DN1
Hollow	CS	CS4
HollowPurple	ED	ED2
Holt	E	None
Homines	A	A1
Homura	K	K1
Honeyfin	EC	None
Honk	EH	None
Hookmount	A	A3
Hoonter	E	None
Hoot	A	A6
Hope	G	G1
Hope4ever	A	A1
Hopey	E	None
Horacetta	EE	None
Horchata	B	B1
Horseradish	CT	None
HorseRider	ER	None
Hortense	CZ	CZ4
Hortihabitatio	DJ	None
HortumSL17	A	A9
Hortus1	ED	ED1
Horus	DN	DN1
Hoshi	BI	BI1
Hosp	B	B6
HotFries	BI	BI2
Hotorobo	CS	CS2
HotPotato	FA	None
Hotshotbaby7	G	G1
Houdini22	A	A4
Howe	CZ	CZ4
HSavage	B	B1
Htur	EJ	None
HubbaBubba	CR	CR4
Hubbs	ED	ED1
Huckleberry	AK	None
HufflyPuff	E	None
Huffy	CU	CU1
Hughesyang	J	None
Hugley	CZ	CZ1
HUHilltop	P	P1
HuhtaEnerson15	A	A5
Hulk	EE	None
Hum25	FQ	None
HumptyDumpty	AR	None
HungryHenry	EA	EA1
Hunnie	AN	None
HunterDalle	AK	None
Huntingdon	AK	None
Huphlepuff	S	None
Hurricane	K	K3
Hutc2	A	A11
Huwbert	GG	None
Huxley	A	A4
Hydra	BD	BD1
Hydro	B	B4
Hydrus	DJ	None
Hyperbowlee	K	K1
Hyperion	EG	None
HyRo	C	C1
Hyzer	CZ	CZ1
I3	C	C1
IAmGroot	EH	None
Ibantik	Singleton	None
Ibhubesi	F	F1
IbOuu	F	F1
Ibrahim	T	None
Icarian	EB	None
Icee	E	None
Iceman	A	A4
IceWarrior	BI	BI1
Ichabod	A	A1
IchabodCrane	BE	BE2
Ichiang	FF	None
Ichor	AQ	None
ICleared	A	A4
Idaho	FE	None
IdentityCrisis	AJ	None
Idergollasper	O	None
Ididsumtinwong	BC	BC3
Idleandcovert	A	A3
IDyn	CR	CR4
Ignacio	BP	None
IgnatiusPatJac	A	A1
IHOP	E	None
IkeLoa	C	C1
ILeeKay	A	A1
Illumine	K	K1
Ilzat	EA	EA1
Immaculata	AK	None
Immanuel3	BF	None
IMpilo	F	F1
Impisi	N	None
ImtiyazSitla	B	B1
Imvubu	B	B10
Inca	E	None
Inchworm	B	B1
Indigenous	BI	BI1
Indigo	BD	BD1
IndiRoo	EJ	None
Indlovu	B	B11
Indlulamithi	AC	None
Indra	A	A6
IndyLu	EB	None
Ingrid	AU	AU3
InigoMontoya	C	C1
Inked	AU	AU7
Inky	K	K1
Insomnia	A	A11
Inspectinfecti	DE	DE2
Inspire2	AN	None
InterFolia	C	C1
Intolerant	BH	None
Invectra	CZ	CZ4
Inventa	EA	EA1
Inventum	F	F1
Inverness	B	B1
InvictusManeo	K	K5
Inyanga	A	A1
Ioannes	EA	EA1
Iota	C	C1
IPhane7	M	M1
Iqorha	A	A1
Iracema64	A	A4
Iridessa	B	B1
Iridoclysis	B	B1
IrishSherpFalk	F	F1
IronMan	A	A2
IsaacEli	B	B1
Isca	A	A3
IsHungry	FF	None
Isiphiwo	A	A6
Island3	I	I1
Isolde	AY	None
Isperia	GJ	None
Issa	AU	AU1
Issa7	ED	ED2
Issimir	C	C1
Issmi	BD	BD2
Iter	AZ	AZ1
Itos	L	L2
ItsyBitsy1	B	B2
IttyBittyPiggy	AZ	AZ1
Itza	BD	BD6
IUFootball	AZ	AZ2
Iwokeuplikedis	A	A2
Ixel	EA	EA11
Izajani	C	C1
Izel	M	M1
Izzy	BD	BD1
IzzyPants24	EE	None
Jaan	A	A2
Jabb	EB	None
Jabbawokkie	F	F2
Jabberwocky	DE	DE1
Jabiru	A	A5
Jabith	A	A11
Jablanski	CY	CY3
JacAttac	B	B1
Jace	Singleton	None
JackieB	BH	None
Jacko	ED	ED1
JackSparrow	A	A1
Jackstina	B	B3
JacoRen57	AB	None
Jada	BK	BK1
Jaek	AQ	None
JaguarMi	B	B4
Jahseh	EE	None
JaimeB	EE	None
Jakelyne	GA	None
JakeO	B	B1
Jalammah	CV	None
Jalebi	DV	None
JalFarm20	F	F1
Jalloh	ER	None
JAMaL	B	B4
Jambalaya	DC	DC1
Jamemuya19	DV	None
James	F	F1
Jamie19	N	None
Jams	CS	CS3
Jamun	AS	AS1
Jamzy	CT	None
Jane	G	G1
Janeemi	AZ	AZ1
JanetJ	FO	None
JangDynasty	O	None
JangoPhett	B	B1
Janiyra	C	C1
Jankie	FP	None
Jannah	EE	None
JaNo	AR	None
Jant	F	F1
Janus	BD	BD2
Janus167	EA	EA1
Jarcob	F	F1
Jarvi	K	K1
Jash	BD	BD1
Jasmine	AV	None
JasmineDragon	AZ	AZ4
JasonD	EA	EA1
Jasper	A	A1
JasperJr	CV	None
JasperRussell	EA	EA1
Jawnski	AO	AO1
JAWS	K	K1
Jay2Jay	BE	BE1
JayCookie	AR	None
Jayden	EC	None
Jaygup	C	C1
Jayhawk	K	K1
JayJay	C	C1
Jaykayelowell	A	A4
Jaylociraptor	BI	BI1
Jazzy4900	FI	None
JC27	A	A1
JCole	CZ	CZ2
JDawG	EF	None
JDog	B	B1
JeanGrey	Singleton	None
Jeanie	CW	CW1
Jebeks	P	P1
Jeckyll	K	K1
Jedediah	C	C1
Jeeves	A	A14
Jefe	EC	None
Jeffabunny	A	A6
JEGGS	AM	None
Jehoshaphat	EG	None
Jella	EE	None
Jellybones	CS	CS2
JellyBread	AY	None
Jemerald	EA	EA6
Jemmno	C	C1
JenCasNa	A	A3
Jenos	EA	EA1
Jeon	W	None
JeppNRM	A	A3
Jera	EJ	None
Jerbirus	EA	EA1
JeriBeth	EA	EA1
Jerky	EE	None
Jerm	A	A2
Jerm2	A	A1
Jerole	AS	AS2
Jesabah	B	B1
JessellCookie	EK	EK1
Jessibeth14	C	C1
Jessica	AN	None
Jester	CA	None
JeTaime	E	None
JetBlade	A	A4
Jevington	BD	BD2
JewelBug	A	A6
Jezreel	C	C1
JF1	K	K4
JF2	A	A3
JF4	A	A3
Jflix2	CF	None
JHC117	A	A3
Jiawan	A	A9
Jifall16	CR	CR2
JigglyPuff	C	C1
Jillium	B	B1
Jiminy	B	B1
JimJam	BE	BE2
JimmyPG	EK	EK2
Jinglebell	F	F1
JingleBells	EF	None
Jingles	EA	EA4
Jinkies	FL	None
Jiraiya	B	B1
JKerns	AO	AO2
JKSyngboy	DE	DE1
Joann	AK	None
Job42	F	F1
JoBros	EE	None
Jobu08	A	A3
Jobypre	L	L3
Jodelie19	DJ	None
JoeDirt	L	L1
Joemato	AZ	AZ1
JoeyJr	F	F1
Johann	EJ	None
John316	CS	CS2
Johnathan	EB	None
JohnDoe	AZ	AZ1
JohnThicc	AZ	AZ4
JoieB	S	None
Jojo24	DY	None
Jolene	G	G1
Jolie1	B	B6
Jolie2	G	G4
Jollipop	EC	None
Jollison	BE	BE2
Jollymon	CP	None
Jonghyun	G	G1
JonJames	DD	None
JooneeDee	EE	None
JoongJeon	A	A4
Jordan	AO	AO2
JordanFarm	EK	EK2
Jordennis	A	A6
Jorgensen	A	A1
Jormungandr	CS	CS3
JorRay	G	G1
Joselito	A	A11
JoshKayV	A	A2
Josuke	EE	None
Journey	N	None
Journey13	A	A2
Jovita	EB	None
Jovo	A	A5
Joy99	K	K1
JoyLin	JA	None
JPandJE	BF	None
JPickles	C	C1
JRok	EE	None
Jsquared	A	A2
Jstan	AZ	AZ1
JSwag	A	A15
Juanyo	EA	EA10
Jubie	L	L3
Judebell	EG	None
Judy	FA	None
Juice456	F	F1
Juicebox	Singleton	None
Juicer	EA	EA6
JuicyJay	J	None
JuJu	CV	None
JulesRay	DJ	None
JuliaChild	A	A1
Julie	FF	None
JulietS	C	C1
Juliette	K	K4
Jumbo	DF	DF3
Jumboset	AK	None
JuneStar	AZ	AZ1
Jung	P	P1
Juniormint	P	P1
Juniper1	F	F1
Juno112	AS	AS3
JustASigh	AH	None
JustBecause	BM	None
JustHall	C	C1
Kabluna	CR	CR2
Kabocha	DQ	None
Kabreeze	AR	None
Kachowdy	A	A3
KADY	A	A3
Kahlid	L	L2
Kahve	B	B1
KaiHaiDragon	EC	None
Kaijohn	EE	None
Kailash	B	B1
Kaine	BD	BD3
Kalah2	J	None
Kalb97	A	A3
Kale	EA	EA1
Kaleb	B	B2
Kalimba	AZ	AZ5
Kalizoi	AK	None
Kalnoky	A	A3
Kalpine	A	A2
Kamaru	DN	DN1
Kamashten	DE	DE1
Kamiyu	B	B3
Kampe	CX	None
Kampy	A	A4
Kamryn	C	C1
KandZ	D	D1
Kanely	A	A1
KannH	EA	EA1
Kanye	E	None
KappaFarmDelta	CV	None
KarasumaRum	B	B5
Karate	EF	None
Kardashian	BI	BI6
Kardesai	AM	None
Kareem	G	G1
Karhdo	F	F1
Kari	P	P1
Karimac	BE	BE2
Karkharias	FA	None
Karp	BK	BK1
Kaseim	CS	CS3
Kasen3	G	G1
KashFlow	J	None
Katalie	BD	BD1
Katalie136	A	A4
KatChan	EA	EA6
Kate	EF	None
Kate33	EB	None
KatherineG	A	A15
Katniss	B	B1
Katyusha	CS	CS4
Katzastrophic	EB	None
Kauala	EA	EA4
Kavo	EA	EA11
KayaCho	B	B6
KayGee	CT	None
Kaylissa	AZ	AZ1
KayMoney	FA	None
KayPaulus	EE	None
Kazan	A	A6
KBG	A	A1
Kboogie	C	C1
KBurrousTX	AR	None
KeAlii	AZ	AZ1
KeaneyLin	AM	None
Keanu	BQ	None
Keelan	DP	None
Keiki	BU	None
Keitabear	DE	DE1
Keitherie	B	B1
Kela	BM	None
Kelcole	EG	None
KellEzio	AT	None
Kels	AN	None
Kelzog	CS	CS2
KendraB23	AS	AS1
Kenmech	A	A1
Kenna	DN	DN1
Kenosha	DJ	None
Kenrey	BK	BK1
KentuckyRacer	BE	BE2
Kenuha5	F	F1
Kenzers	EB	None
Keough	EK	EK2
Kepler	AS	AS2
Kerberos	A	A2
Kerry	DJ	None
Kersh	F	F1
Keshu	K	K3
Kevanna	EE	None
Kevin1	N	None
KevinMinion	AU	AU6
Kewpiedoll	DE	DE1
Keziacharles14	A	A9
KFPoly	A	A4
Khaleesi	C	C1
Khan1	B	B1
Kharcho	FM	None
Kheth	B	B2
Khuang	FS	None
KHumphrey	AS	AS3
KidneyBean	CR	CR2
Kieran	EB	None
Kihatsu	FF	None
Kikiko	EM	EM2
Kikipoo	B	B1
Kiko	DB	None
KilKor	P	P1
KillerQueen	EG	None
KillerTomato	EE	None
Killigrew	A	A1
Kimba	A	A11
Kimberlium	F	F1
Kimbrough	B	B1
Kimchi	E	None
Kimchi1738	EN	None
KimJongPhill	BR	None
KimmyK	DC	DC1
Kimona	A	A19
Kinbote	Q	None
King2	AO	AO1
KingBob	AK	None
KingCyrus	A	A2
KingJulian	F	F1
KingJulien	EA	EA1
KingKamren	EK	None
KingMidas	F	F1
Kingmustik0402	A	A4
KingPhillip3	O	None
Kingsley	F	F1
Kingsolomon	L	L3
KingstonB	CP	None
KingTut	B	B1
KingVeVeVe	B	B1
Kinmap	A	A21
Kinny	AU	AU6
Kipper29	A	A6
KirDoubleO7	L	L3
KiSi	K	K1
Kita	CZ	CZ1
Kithara	Singleton	None
Kitkat	AT	None
KittenMittens	A	A10
Kittykat	AK	None
Klein	J	None
KleverKiS	M	M1
Klevey	FH	None
KlimbOn	B	B1
Klimt	EA	EA1
Kloppinator	B	B1
KLucky39	B	B1
KNG13	FE	None
Knocker	B	B9
Knox	EA	EA1
Koan	A	A4
Koduck	A	A2
Koella	F	F1
Koguma	C	C1
Kojax4	EE	None
Koji	EA	EA4
Koko	A	A6
Kolhan	B	B2
Konstantine	H	H1
Koreni	A	A4
Korra	AK	None
Kors	EF	None
Kosier	EK	EK2
Kostya	E	None
Kovu	AL	None
Kowalski	EC	None
Kozie	EI	None
Kradal	BM	None
Krakatau	F	F1
Krampus	EF	None
Kratark	A	A4
Kratio	K	K5
Kraw	K	K4
Kremtemulon	A	A4
Krili	O	None
Krishelle	CA	None
KristaRAM	F	F1
Kristoff	A	A10
Kromp	Singleton	None
Kronus	B	B3
Kroos	DE	DE1
Kropertea	L	L4
Krueger	K	K6
Krypton555	L	L3
Ksquared	P	P1
KSSJEB	A	A1
KSunshine22	FC	None
Kubed	BU	None
Kubulix	AP	AP2
Kudefre	DU	DU1
Kugel	A	A1
Kukla	FJ	None
Kuleana	AS	AS2
Kumao	Singleton	None
Kumotta	FB	None
Kumquat	BF	None
Kurt	CR	CR2
Kurt1	EA	EA1
Kuwabara	DN	DN4
Kvothe	CS	CS4
Kwadwo	B	B1
Kwekel	DE	DE3
Kwksand96	B	B1
Kwobi	DE	DE1
Kyee	A	A4
Kykar	A	A1
KylieMac	AN	None
KyMonks1A	A	A1
KyriosFaba	EE	None
Kyva	EG	None
L5	A	A2
Labelle	U	None
Labeouficaum	B	B1
Labradorite	C	C1
LadyAstra	AZ	AZ4
LadyBird	A	A2
LadyJasley	AV	None
Lahirium	CS	CS3
Lahqtemish	EB	None
Laila	AN	None
Lakshmi	AK	None
Lambano	B	B4
Lamberg	CZ	CZ2
Lambert1	A	A3
Lambo	DV	None
Lamina13	A	A1
Landor	A	A2
Langerak	P	P1
Lannister	BD	BD1
LappelDuVide	A	A4
Larenn	A	A2
Larnav	BE	BE1
Laroye	AL	None
LarryKay	A	A3
Lars	B	B2
Larva	K	K5
Lasagna	AK	None
LasagnaCat	B	B1
Lasso	B	B1
LastHope	K	K1
LastJedi	F	F1
LastResort	A	A15
Latch	C	C1
LaterM	K	K1
Latretium	F	F1
Lauchelly	BU	None
Lauer	CT	None
Laurie	B	B2
LavAbarElk	DV	None
LaviMo	EE	None
Lawnathon	AY	None
LazerLemon	BH	None
LBerry	A	A3
Lea83	K	K3
Leaf	GC	None
Leafus	EA	EA1
Leafy	EE	None
Leathea	AU	AU6
Lebo14	K	K4
LeBron	L	L1
Lederberg	EP	None
Lee7	C	C1
LeeLot	B	B1
LeeroyJ	AO	AO2
LeeroyJenkins	GB	None
Legacy	BD	BD1
Lego	AZ	AZ1
Lego3393	B	B1
Legolas	B	B1
Lehmann	B	B1
LeiMonet	B	B1
LeMond	K	K1
LemonPepper	EE	None
LemonSlice	B	B1
Lemur	A	A4
Lemuria	G	G4
Lennon	DE	DE1
Lennox	AK	None
Lenoshki	DQ	None
Lenoxika	FF	None
Leo04	BE	BE1
LeoAvram	A	A4
Leogania	A	A2
LeoJr	FC	None
Leona	AS	AS3
Leonard	DE	DE2
Leopard	AE	None
Leozinho	F	F1
Leperchaun	F	F1
Lephleur	B	B2
Leroy	DN	DN1
Lesedi	A	A1
Lesiram	GF	None
LesNorah	EK	EK1
Leston	K	K5
LestyG	B	B3
Lethe	C	C1
Lev2	A	A5
Levia	A	A1
Leviathan	A	A2
Leviosa	BU	None
Leviticus	BD	BD1
Lewan	L	L2
Lewando	AU	AU6
LHTSCC	A	A4
Liandry	BE	BE1
Liberone	GI	None
LibertyBell	BI	BI3
Librie	EA	EA5
Licorice	A	A1
Lidong	CS	CS3
Liebe	AZ	AZ2
Liefie	G	G1
Lifes	GB	None
LifeSavor	C	C1
Ligma	DR	None
Lika	BD	BD1
Lila22	DV	None
Lilac	E	None
Lilas	CY	CY1
LilBandit	BU	None
Lilbeanie	DE	DE5
LilBib	A	A1
Lilbit	S	None
Lilbooboo	BB	BB1
Lilbunny	A	A6
LilDestine	L	L2
LilHam	DE	DE1
LilHazelnut	Q	None
LilhomieP	M	M1
LilHuddy	AU	AU2
Lilith	A	A3
Lilizi	E	None
Lilleskat	A	A9
Lillie	CA	None
Lilmac1015	FH	None
LilMartin	BE	BE1
LilMcDreamy	B	B12
LilMoolah	F	F1
Lilo27	EB	None
LilPharaoh	K	K1
Lilpickle	E	None
LilSmirk	B	B2
LilSpotty	Singleton	None
LilStuart	AK	None
LilTerminator	EA	EA5
LilTurb	A	A2
LilyLou	EK	EK1
LilyPad	DG	DG1
LimaBean	EB	None
Limpid	BK	BK1
Linayshia	EJ	None
Linda	AW	None
LindNT	K	K1
Linetti	CS	CS2
Link	AN	None
LinStu	C	C1
Linus	AR	None
LionelHutz	EE	None
LionsBait	A	A2
LiSara	AL	None
Lishka	BC	BC3
LitninMcQueen	DN	DN1
Litotes	AK	None
LittleB	A	A4
LittleCherry	A	A5
LittleE	J	None
LittleFella	DG	DG2
LittleFortune	EC	None
LittleGuy	A	A4
LittleLaf	S	None
LittleMinkey	B	B13
LittleMunchkin	DR	None
LittleShirley	F	F1
LittleTokyo	AS	AS2
Littleton	C	C1
Livingwater	EE	None
LiyuLake	L	L3
Lizalica	AZ	AZ1
LizLemon	B	B2
Lizz	BN	None
Lizziana	F	F1
Lizzo	CS	CS2
Llama	F	F1
Llemily	EG	None
Llij	F	F1
Llorens	K	K1
Loadrie	L	L2
Loanshark	C	C1
Loca	EE	None
LochMonster	A	A4
Lockley	A	A1
Lokk	A	A2
Lola20	EE	None
Lolalove	B	B4
LolaVinca	C	C1
Lollipop1437	CR	CR3
Lolly9	L	L3
London	AZ	AZ1
LonelyBoi	CY	CY7
Lonelysoil	EG	None
LoneWolf	A	A9
Longacauda	B	B1
Loofah	BD	BD2
LookingGlass	C	C1
Looper	A	A15
Lopsy	B	B1
Lopton	A	A1
LordBart	EF	None
Lorde	F	F1
LordFarquaad	CZ	CZ2
LordLeafolot	C	C1
Lore	AN	None
Lorelei	BD	BD1
Lorenzo	A	A4
Loretta	AU	AU3
Losacky	GA	None
Loser	A	A2
LostAndPhound	B	B1
Louie6	A	A3
LouisV14	G	G1
LouisXIV	AN	None
Love	DE	DE1
Lovelyunicorn	EA	EA1
Loviatar	EB	None
Lowa	A	A3
Lozinak	CQ	CQ1
LRRHood	C	C1
Lton	CZ	None
Luchador	A	A14
Lucivia	A	A11
Lucky10	DH	None
Lucky2013	J	None
Lucky3	EA	EA4
LuckyBarnes	Singleton	None
LuckyLeo	DV	None
LuckyMarjie	B	B1
LuckySocke	BS	None
Lucy	AK	None
Lucyedi	A	A16
LucySwiss	AU	AU1
Ludgate	EA	EA1
LugYA	A	A3
Luke	Q	None
LukeCage	BE	BE2
Lukepolites	Singleton	None
Luker	CS	CS3
Lukilu	C	C1
Lululemon	BE	BE1
Lulumae	B	B1
Lulwa	B	B1
Lumine	B	B1
Lumos	L	L3
Luna18	EA	EA6
Luna22	Q	None
LunaBlu	F	F1
Lunahalos	K	K1
Lunar	AS	AS2
Lunareta	C	C1
LunarLander	A	A1
LunaStella	F	F4
Lunatic	EE	None
Lunsford	A	A4
Lupine	ED	ED1
Lutum	DN	DN1
Luxx	EE	None
LuzDeMundo	GE	None
Lyell	ED	ED2
Lymara	AR	None
Lynlen	EB	None
Lynnae	L	L2
Lysidious	CV	None
MA5	A	A3
Mabel	A	A11
Mabodamaca	EH	None
Maby2021	C	C1
MacGully	CR	CR7
MaCh	A	A11
MacKat	K	K1
MAckerman	L	L1
MacnCheese	K	K3
Maco6	AB	None
Madamato	BI	BI1
MadamMonkfish	E	None
Madebyisha	EE	None
Madeline	CZ	CZ1
Madi	DG	DG1
Madiba	F	F1
MadKillah	O	None
MadMarie	A	A3
MadMen	F	F1
Madraxi	CF	None
Madruga	U	None
Madvan	DJ	None
MaeLinda	EA	EA1
Mag7	B	B1
Magel	DJ	None
Maggie	AN	None
Magic8	B	B1
MagicMan	DB	None
Magnar	A	A1
Magnito	A	A1
Magpie	B	B4
Magritte	Singleton	None
Magsby	N	None
MaGuCo	AZ	AZ2
Mahavrat	F	F1
Mahdia	CD	None
Maih	BG	None
Mainiac	A	A3
Maja	FO	None
Majeke	P	P1
Majesty	EE	None
MajinBuu	DJ	None
MajorMajor	A	A2
Makai	AU	AU5
MakCheese	DW	None
Makemake	A	A1
MakoManhole	DR	None
Makoto	AK	None
Malachai	CV	None
MalagasyRose	AG	None
Malec	A	A2
Malibo	DW	None
Maliketh	G	G1
Malinsilva	A	A3
Malisha	DN	None
Malithi	P	P1
Malthus	K	K4
MamaPearl	AK	None
MamaT	GI	None
Maminiaina	A	A9
Mana	B	B1
Manad	B	B1
ManAs	EE	None
Manasvini	CZ	CZ1
Manatee	A	A1
Manda	E	None
Mandalorian	EA	EA10
Mandlovu	F	F1
Maneater	EE	None
Maneekul	BD	BD1
Mangeria	C	C1
Mangethe	P	P1
MAnor	CT	None
ManRay	EA	EA1
Mantle	JB	JB2
Mantra	F	F1
Manu	A	A3
Manuel	BF	None
Mao1	AD	None
Marav	BD	BD2
Maravista	F	F1
Marcell	A	A1
Marchesa	A	A3
Marchy	A	A1
Marcie	EG	None
Marco3	A	A1
Marcoliusprime	K	K2
Mareelih	DS	None
Margaery	EI	None
Margaret	CT	None
MargaretKali	FB	None
Marge	A	A1
Margo	A	A3
Maria1952	AK	None
Maridalia	CZ	CZ1
Marie	A	A3
Marietta	CR	CR4
Mariokart	DR	None
Mariposa	AN	None
Marius	A	A3
Marker	F	F1
MarkPhew	K	K1
Marky	BH	None
Marley1013	B	B3
Marleymoo	J	None
Marlia	B	B3
Marmie	G	G1
Maroc7	A	A1
MarQuardt	A	A3
Marsha	A	A1
Marshawn	K	K6
Marshmallow	E	None
Marsus	BE	BE1
Marteena	CY	CY1
Martha	AO	AO2
Martik	F	F1
Martin	EA	EA1
Maru	B	B1
Maruru	FG	None
Marvin	S	None
MaryBeth	A	A1
MarysWell	A	A5
MaryV	V	None
Maselop	CR	CR6
Mashley	EG	None
Mask	AD	None
Maskar	B	B1
Massimo	AN	None
MasterPitts	EE	None
MasterPo	B	B2
Matalotodo	B	B1
MaterMagnus	AY	None
Matsumoto	C	C1
Matteo	CZ	CZ2
Mattes	F	F1
Matzah	EI	None
Maureen	AZ	AZ2
MaVan	CT	None
Maverick	A	A4
Maxo	A	A4
Maxxinista	E	None
Maya	BI	BI1
Mayonnaise	A	A4
Mayweather	CT	None
Mazhar510	A	A4
Mazun	EK	EK2
McFly	A	A6
McGalleon	EA	EA1
McGee	C	C1
McGonagall	CW	CW1
McGuire	A	A1
McKinley	DE	DE1
Mcklovin	CZ	CZ4
McMater	K	K1
Mcshane	B	B1
McShie	EE	None
McSinger	A	A1
MCubed	EA	EA2
McWolfish	C	C1
Mdavu	K	K1
MEAK	BU	None
MeaningOfLife	K	K1
Mecca	B	B1
Medindi	F	F1
MediumFry	AU	AU4
Medusa	A	A4
MeeZee	A	A4
Megabear	W	None
Megamind	C	C1
Megamind20	B	B1
Megan	EC	None
MeganNoll	AK	None
MeganTheeKilla	BK	BK1
Megatron	B	B1
Megatron06	H	H1
Megiddo	P	P1
Megsy	K	K1
Meibysrarus	BI	BI1
Melba	CV	None
MelBee03	EE	None
MelBins	DE	DE2
Melc17	B	B1
Melissauren88	F	F1
Mellie	CV	None
MellowYellow	AP	AP2
Melons	AS	AS2
Melpomini	C	C1
MelsMeow	B	B1
Melville	N	None
Melvin	A	A4
MementoMori	EI	None
Mendel	FD	None
Mendokysei	T	None
MenE	GA	None
Mentos	EG	None
Mercedes	EA	None
MerCougar	CR	CR2
Mercurio	G	G4
Merry	EC	None
Mesh1	B	B1
Mesmerelda	B	B1
MetalQZJ	A	A1
Metamorphoo	EC	None
Methuselah	A	A3
Meyran	DT	None
MiamiPanther	EK	EK1
Miaurora	EE	None
MiaZeal	J	None
Micasa	A	A5
MichaelPhcott	B	B1
MichaelScott	CZ	CZ4
Michelle	AW	None
MichelleMyBell	N	None
Michley	A	A1
Microdon	BH	None
Microwolf	A	A3
MiculUcigas	A	A2
MicyPS	EQ	None
Midas2	A	A5
MidnightRain	AY	None
Miek	BI	BI4
MikeLiesIn	C	C1
Miko	A	A2
Mikota	B	B1
Mikro	C	C1
Mikronejon	DQ	None
Mila11	EG	None
MilanaBonita	F	F1
Milani	EJ	None
Milcery	A	A5
Mildred21	BE	BE1
Miley16	L	L2
MilleniumForce	F	F1
Millski	A	A4
Milly	K	K2
MillyPhilly	EA	EA1
Milomuff	EB	None
Mima20	DV	None
Mimi	FC	None
Mimi16	JB	JB1
Min1	Singleton	None
MindFlayer	BE	BE2
Mindy	E	None
MinecraftSteve	A	A15
Minerva	J	None
MiniBagel	AU	AU1
MiniBoss	B	B1
MiniLon	L	L3
Minima	EE	None
MiniMac	L	L3
MiniMommy	AZ	AZ4
MinionDave	F	F1
Miniwave	E	None
Minnie	F	F1
Minos	CS	CS3
MintFen	CV	None
MintFritos	DQ	None
Miramae	A	A4
MirimarMandM	EE	None
Miryou	K	K5
Misaeng	AK	None
Mischief19	BG	None
Misfit	E	None
Misha28	F	F1
Miskis	CQ	CQ1
Misomonster	A	A3
MissAmericana	EM	EM2
MissDaisy	K	K4
MissRona	CV	None
MissSwiss	AZ	AZ1
MissWhite	A	A2
MISSy	E	None
MisterCuddles	F	F1
Mithril	B	B4
MitKao	B	B1
Mitti	K	K4
MK4	A	A3
MkaliMitinis3	L	L2
Mkhuseli	A	A1
MmasiCarm	B	B3
Moab	BK	BK1
Moby	C	C1
Mocha12	CZ	CZ2
ModicumRichard	DZ	None
Modragons	F	F1
MoiGyank	DV	None
Moiqah	C	C1
Mojorita	BC	BC1
Moki	AK	None
Moldemort	E	None
Moleficent	EK	EK2
Molivia	AQ	None
Molly	A	A1
Mollymur	DL	None
Moloch	AN	None
Momo	C	C1
MoMoMixon	C	C1
Momos	JB	JB1
MonChoix	EA	EA1
Monet	A	A1
MoneyMay	A	A3
Montavir	A	A3
Montpel	C	C1
Monty	CS	CS2
MontyDev	R	None
MooKitty	AX	None
MooMoo	Singleton	None
Moonbeam	F	F1
Moonflower	DB	None
MoontowerMania	DE	DE1
MOOREtheMARYer	G	G3
Moose	A	A1
Moosehead	CZ	CZ6
Mooshroom	AM	None
Moostard	L	L3
Moozy	BI	BI2
Mopey	D	D1
Mordred	AR	None
Morgana	DZ	None
Morgushi	B	B1
Mori	O	None
MoRicky	GH	None
MorillMayhem	EG	None
Morizzled23	C	C1
Morkie	DH	None
Morpher26	A	A4
Morrigan	EA	EA6
Morrill	EK	EK2
Morrissey	CD	None
Morrow	A	A4
Mortcellus	B	B3
Morty	B	B1
Morty007	B	B3
MortyNRick	DN	None
MortySmith	EF	None
Mosaic	B	B1
Mosby	E	None
MosMoris	S	None
Moss	AZ	AZ5
MossRose	DR	None
Mossy	DJ	None
Mova	F	F1
Mowgli	G	G1
MoyaNatalis	AR	None
Moyashi	BU	None
Mozy	F	F1
MPhalcon	E	None
MPlant7149	A	A1
MrAaronian	AW	None
MRabcd	B	B1
MrAK	BU	None
MrGloopy	AK	None
MrGordo	A	A1
MrGreen	EE	None
MrMagoo	M	M2
MrMiyagi	AC	None
MrPhizzler	B	B1
MrSmee	FQ	None
MrWorldwide	EA	EA1
MrWormie	CS	CS3
Mryolo	A	A1
Ms6	F	F1
Msay19	CS	CS2
MScarn	CT	None
MsGreen	L	L3
MsUbiquitous	EB	None
mu16	Singleton	None
MuchMore	A	A3
Mudcat	AM	None
Muddy	AB	None
Mudpuppy	AZ	AZ1
Mudslide	B	B4
Mufasa	K	K2
Mufasa8	FG	None
MuffinTheCat	GE	None
Mugiwara	BE	BE2
Mulan	B	B1
Mulch	DI	None
MulchExplorer	F	F1
MulchMansion	BE	BE1
MulchSalad	F	F7
Mulciber	A	A11
Mule	A	A1
Munch	A	A11
Mundrea	A	A4
MunkgeeRoachy	CT	None
Muntaha	BK	BK2
Murai	O	None
Murdoc	B	B1
Murica	E	None
Murp	CV	None
Murphy	E	None
Murucutumbu	K	K1
Musetta	ED	ED2
Museum	A	A1
Mutaforma13	F	F1
Mutante	B	B1
Muttlie	AN	None
Mutzi	DC	DC1
MUWow	AY	None
Mwanjiwa	F	F1
Mynx	K	K1
MyraDee	A	A18
Myrale	E	None
Myram	EE	None
Myrna	C	C2
Mysterious	B	B5
Mysterium	AZ	AZ5
Mysticmoon	DJ	None
Myxus	A	A9
Nabi	BD	BD1
Naby	EE	None
Naca	A	A5
Nacho	B	B1
Nadeem	DI	None
NadineRae	CR	CR4
Nadmeg	DJ	None
Nagem	EA	EA1
Naiad	CA	None
Naija	C	C1
Naira	A	A1
Nairb	T	None
Naji	A	A2
Nala	E	None
Namago	EG	None
Namo	BI	BI1
Namsahir	EE	None
Nanao	B	B4
Nancia	AK	None
Nancinator	CA	None
NancyRae	DI	None
Nandita	FF	None
Nangang	B	B5
Nanodon	BD	BD1
Nanosmite	M	M3
Napoleon13	C	C1
NapoleonB	AM	None
Nappy	C	C1
NarutoRun	EF	None
NaSiaTalie	A	A2
Nason	AM	None
Natasha	AW	None
NatB6	CR	CR2
Nathan	B	B1
NathanVaag	AO	AO1
Natkenzie	DE	DE4
Natosaleda	CA	None
Nattles	EA	EA1
Naval22	C	C1
Navi1117	AU	AU6
Navo	BE	BE1
Nazo	P	P4
NearlyHeadless	A	A8
Nebkiss	X	None
Nebs	A	A4
Nebulosus	A	A15
Nebulous	EA	EA5
Necrophoxinus	ED	ED2
Necropolis	P	P1
Nedarya	A	A15
NedWong	C	C1
Neeharika16	A	A6
Neferthena	EA	EA5
NEHalo	A	A1
Nehemiah	B	B5
Neighly	K	K3
Nekros	J	None
NelitzaMV	E	None
Nellie	AV	None
Nemo27	A	A4
Nenae	N	None
Neobush	CZ	CZ1
Neoevie	CS	CS3
Neos5	B	B3
Neptune	EF	None
Nerdos	BD	BD1
Nergal	AG	None
Nerujay	A	A1
Nesbitt	BL	None
Nette	T	None
Nettuno	CZ	CZ2
Netyap	L	L2
NeumannU	EE	None
Neuvillette	FR	None
Neville	DU	DU2
NewHope4	F	F1
Newman	B	B1
Newrala	A	A6
Newt	CS	CS3
Ngannou	C	C1
NHagos	DR	None
Nhonho	A	A1
Niagara	CS	CS4
Nibb	K	K1
Nibbles	CT	None
NiceHouse	CE	None
Nicholas	L	L3
Nicholasp3	L	L2
NickSell	EA	EA1
Nicky22	EB	None
Nicole21	B	B1
Nicole72	EC	None
NicoleTera	A	A2
Nidhogg	C	C1
NiebruSaylor	O	None
Niffler	EE	None
Nigel	B	B4
Nightmare	AU	AU1
NihilNomen	J	None
Nikan	AP	AP2
Nikao	K	K1
Nike	EG	None
Niklas	K	K1
Niktson	AU	AU1
Nilo	R	None
Nimbo	F	F1
Nimi13	CS	CS3
Nimrod	E	None
Nina	CT	None
Niobe	AZ	AZ1
Nirvana	BM	None
Nishikigoi	BD	BD2
Nithya	DJ	None
Nitro	AZ	AZ1
Nitzel	F	F1
Nivinsha	AU	AU1
Nivrat	F	F1
Niza	A	A1
Nobel	EE	None
Nodigi	CT	None
Noelani	EE	None
Noella	A	A3
Noelle	A	A4
Noely	FE	None
Nonagon	JD	None
NoodlelyBoi	EC	None
NoodleTree	C	C1
NootNoot	BE	BE1
NoPickles	DJ	None
Norbert	A	A3
Nordenberg	DE	DE1
Norm	C	C1
NormanBulbieJr	F	F1
NorManre	DV	None
NorthStar	A	A4
Norvs	CQ	CQ1
Norz	A	A1
NoShow	AB	None
NosilaM	CR	CR2
NoSleep	E	None
Nostromo	AO	AO3
NoSwimming	FO	None
NotAPhaseMom	A	A4
NothingSpecial	A	A2
Nova	D	D1
Nova53	CG	None
NovaSharks	DV	None
November	K	K6
NovoPizza	Q	None
NovumRegina	CR	CR2
Nozo	B	B3
Nubi	DC	DC1
Nubia	AK	None
Nucci	EA	EA10
NuevoMundo	C	C1
Numberten	B	B1
Nutello	K	K1
Nyala	B	B1
Nyceirae	DT	None
NyleyClemson	AP	AP2
Nymphadora	CZ	CZ1
Nyxis	A	A4
Oaker	H	H1
Oaklynn	EE	None
Oatly	EK	EK1
Oats	EA	EA1
Obama12	A	A4
ObiToo	AZ	AZ1
ObLaDi	DZ	None
Obliviate	CV	None
OBUpride	Q	None
Obutu	B	B3
Ochi17	F	F1
OctaviousRex	G	G1
Octobien14	DU	DU1
Octopus	EE	None
ODay	DN	None
Odesza	DJ	None
OdetoJoy	EE	None
Odette	J	None
Odin	A	A2
Odyssey395	AP	AP2
OfUltron	F	F1
Ogopogo	F	F1
Ohfah	A	A4
Ohgeesy	CZ	None
OhMyWard	DJ	None
Ohno789	A	A1
OhShagHennessy	L	L1
OKaNui	A	A4
OKCentral2016	A	A10
OkiRoe	K	K5
Oksu	F	F1
Olak	B	B1
OlanP	A	A3
OldBen	F	F1
OldNelly	EA	EA1
Olga	G	G1
OlgasClover	DJ	None
Olicious	BF	None
OlinDD	ED	ED1
Oline	B	B1
Olive	B	B1
OliverWalter	B	B1
Olivio	B	B3
Oliynyk	BD	BD1
Ollie	A	A3
Olliecat	EB	None
Ollypop	AP	AP2
Olympi	EJ	None
OlympiaSaint	F	F1
OlympicHelado	BI	BI1
OMalley	AK	None
Omar	BD	BD2
Omega	J	None
OmniCritical	K	K4
Omnicron	K	K5
Omniscient	B	B1
OneDirection	CZ	CZ6
OneinaGillian	EG	None
OneUp	CQ	CQ2
Onglai	A	A9
Onika	EC	None
OnionKnight	Singleton	None
Onyinye	AE	None
Oofda	A	A15
Oogie	DQ	None
Oogway	A	A1
Oosterbaan	B	B1
Opia	B	B2
Opie	DB	None
Optimus	J	None
Orange	A	A11
OrangeOswald	B	B3
Orcanus	AS	AS1
Orchid	CX	None
OrediggerDelux	C	C1
Oregano	CZ	CZ4
Orfeu	B	B1
Origami	AZ	AZ4
Orion	B	B1
OrionPax	E	None
Orla	CT	None
Orwigg	B	B1
Oscar	K	K1
OscarSo	GJ	None
OSmaximus	B	B1
OtsoOtso	AS	AS2
Ottawa	FM	None
OtterstedtS21	DV	None
Otwor	EE	None
OurGirlNessie	AK	None
Ouroboros	BU	None
Outis	CR	CR2
Ovechkin	F	F1
OverHedge	EF	None
Owens	EE	None
OwlsT2W	F	F1
Oxtober96	EA	EA1
Oxynfrius	AK	None
Ozzie	BD	BD1
OzzyJ	BD	BD1
P1.1	BU	None
P100.1	BU	None
P100A	BU	None
P100D	BU	None
P101A	BU	None
P104A	BU	None
P104B	BU	None
P105	BU	None
P106A	BU	None
P106C	BU	None
P106I	BU	None
P106L	BU	None
P106M	BU	None
P107A	BU	None
P107C	BU	None
P108C	BU	None
P14.4	BU	None
P28Green	A	A3
P3MA	Singleton	None
P9.1	BU	None
PA6	BU	None
Pablito	BD	BD2
Pabst	EK	EK1
Pacc40	F	F1
Pace1224	G	G2
PacerPaul	A	A1
Pacifista	B	B1
PackMan	A	A9
PacManQ	BE	BE1
PAD20	BU	None
Padfoot	K	K1
Padpat	K	K1
Paedore	BD	BD2
Paella	FK	None
PaintedDog	I	I1
PainterBoy	A	A16
Paito	G	G1
Pajaza	EA	EA3
Pakusa	DQ	None
Palestino	A	A4
Palpatine	E	None
Panamaxus	A	A3
Panchaali	FC	None
Panchino	N	None
PantheRoc	CZ	CZ3
Paola	K	K5
Paolo	BD	BD2
PaoPu	EE	None
Papafritta	EA	EA1
PapayaSalad	BC	BC3
Paperbeatsrock	E	None
Papez	A	A1
Paphu	A	A1
Papyrus	R	None
Parada	DI	None
Paradiddles	BE	BE1
Paraselene	A	A1
Pari	A	A1
Paries	DE	DE1
ParkTD	C	C1
ParleG	EA	EA1
Parliament	A	A1
Parmesanjohn	N	None
Partridge	CA	None
PartyCup	AK	None
ParvusTarda	DV	None
PAS50	BU	None
PascalRango	A	A1
Paschalis	EC	None
PastaFagioli	EB	None
Pat3	E	None
Patbob	FC	None
Patelgo	BK	BK1
Patience	U	None
Patio	CR	CR3
Patos	DV	None
PatrickStar	CX	None
Patt	K	K4
Patter	C	C1
PattyP	A	A1
PauloDiaboli	GD	GD1
Pavlo	ED	ED1
Pavo	BD	BD3
Pawn	A	A3
Payneful	A	A1
PBI1	D	D1
PCoral7	CV	None
PeaceMeal1	A	A10
Peaches	A	A4
Peanam	K	K1
PeanutPie	P	P1
Peas	FA	None
Peeb	G	G1
Peebs	BE	BE1
Peel	K	K1
Peep	EA	EA1
PeggyLeg03	FA	None
PegLeg	M	M1
Pelletreau	AS	AS1
Pelly	A	A1
Pembroke	A	A3
Penelope2018	D	D1
PenguinLover67	B	B9
Penne	JB	JB1
Penny1	A	A3
PensacolaC28	Singleton	None
Pepe	A	A1
Pepe25	EG	None
Pepperoni	CZ	None
Pepperwood	BE	BE1
Peppino	EA	EA1
Pepy6	CC	None
Percastrophe	BF	None
Percival	EH	None
Peregrin	CB	None
Peridot	F	F1
Periodt	G	G1
Periwinkle	DN	DN1
Perkunas	DJ	None
PermaG	EJ	None
Perplexer	A	A4
Perseus	A	A1
Persimmon	BE	BE1
Persistence	AY	None
PestoPenguin	DJ	None
PeterPeter	A	A4
Petersenfast	A	A11
Peterson	A	A1
PeteyPab	EN	None
PetiteSangsue	A	A4
Petito	DJ	None
Petp2012	A	A1
Petra	CV	None
Petra64142	E	None
Petruchio	A	A1
PetterN	A	A5
PFR1	BX	None
PFR2	BX	None
PG1	B	B1
PGHhamlin	A	A3
Ph8s	A	A2
Phabba	C	C2
Phabia	EG	None
Phabuloso	DN	DN1
Phaby	AU	AU2
Phacado	A	A4
Phaded	A	A2
Phaeder	A	A9
Phaedrus	B	B3
Phaila	AU	AU6
PhailMary	CA	None
Phaja	E	None
Phalaborwa	D	D1
Phalconet	F	F1
Phalm	P	P1
Phamished	B	B1
PhancyPhin	N	None
Phanita	EA	EA2
Phanphagia	F	F1
Phantasmagoria	B	B2
Phantastic	A	A3
PHappiness	F	F1
Pharaoh	A	A12
Pharb	K	K3
Phareon	B	B1
Pharky	EK	EK2
Pharpay	EF	None
Pharsalus	E	None
Phasih	F	F1
PhatBacter	E	None
PhatCats2014	B	B1
PhatLouie	B	B1
Phatniss	F	F1
Phauci	DE	DE2
Phaux	E	None
Phayeta	B	B3
Phayonce	P	P5
Phedro	EK	EK2
PhedwardCullen	EC	None
Phegasus	P	P1
Phelemich	B	B5
Phelipe	A	A4
PhelpsODU	K	K6
Phendrix	DK	None
PhenghisKhan	B	B1
Phepper	DJ	None
Pherbot	EA	EA4
Pherdinand	B	B1
Pherferi	EA	EA1
Phergie	B	B1
Pherobrine	DJ	None
PherrisBueller	A	A1
PherryCruz	BI	BI2
PhesterPhotato	F	F1
Phettuccine	BD	BD1
phiAsp2	Singleton	None
phiBT1	BB	BB1
phiC31	BB	BB1
phiCAM	BD	BD3
Phiderman	EA	EA1
Phighter1804	A	A4
PhigPhack	EB	None
phiHau3	BD	BD4
Phillis	A	A8
Philly	B	B3
PhillyJawn	GA	None
PhillyPhilly	ED	ED1
Philon9	CS	CS4
Philonius	N	None
Philus	F	F1
Phinally	DE	DE2
Phineas	P	P1
PhineBark	A	A1
Phingu	GA	None
PhinkBoden	CQ	CQ1
Phinky	EG	None
Phipps	B	B1
Phireproof	EA	EA1
PhirstandPhine	AS	AS2
phiSASD1	BJ	None
phiSAV	Singleton	None
Phisb	EB	None
Phish	G	G1
PhishRPhriends	A	A3
Phishy	DT	None
Phistory	DN	DN1
Phives	AZ	AZ1
Phlegm	C	C1
Phlei	A	A13
Phleuron	B	B1
Phlippers	A	A1
PhlipPhlop	F	F1
Phlop	DC	DC1
Phlorence	A	A5
Phloss	N	None
PhluffyCoco	AS	AS3
Phlyer	B	B3
Phoebe	A	A3
Phoebus	J	None
Phogo	EK	EK1
Phomeo	CR	CR2
Phonegingi	GA	None
Phonnegut	A	A9
Phontbonne	A	A4
PhorbesPhlower	DH	None
Phorgeous	EC	None
Phox	C	C1
Phoxy	A	A3
Phractured	EK	EK2
Phrampa	FC	None
Phrancesco	EC	None
Phrank	K	K6
Phrank15	AY	None
Phrankenstein	CA	None
PhrankReynolds	B	B1
Phrann	N	None
Phranny	A	A3
Phrappuccino	AA	None
Phreak	G	G1
PhredFlintston	EA	EA1
Phredrick	BK	BK1
Phreeze	H	H1
PhriedRice	EK	EK2
Phriends	EA	EA1
PhriskyACE	CZ	CZ4
PhrodoBaggins	B	B1
Phroglets	Singleton	None
PhrostedPhlake	CV	None
PhrostyMug	A	A1
Phrux	E	None
PHTowN	BN	None
PhunaPhoke	EF	None
Phunky	B	B1
Phusco	C	C1
PhuzzTulsa	AP	AP2
Piatt	K	K1
Picard	BC	BC1
Piccadilly	BP	None
Piccoletto	AO	AO1
Pickett	CZ	CZ2
PickleBack	A	A5
Pickles13	GA	None
Picnic	EE	None
Pier	C	C1
PierreOrion	EC	None
PierreThree	CS	CS2
Piglet	B	B1
Pigu	FB	None
Pikmin	EA	EA3
Piku	FE	None
Pimento	DI	None
Pine5	Singleton	None
PineapplePizza	GI	None
PineapplePluto	EK	EK1
PinheadLarry	B	B1
PinkCoffee	DC	DC1
Pinkcreek	C	C1
PinkFriday	AK	None
PinkiePie	BE	BE1
Pinkman	B	B1
PinkPlastic	A	A1
PinkYoshi	G	G1
Pinnie	G	G3
Pinto	A	A1
Pio	C	C1
Pioneer	A	A9
Pioneer3	ED	ED1
Pipcraft	A	A4
Pipefish	B	B3
Piper2020	F	F1
Piperis	EC	None
PiperSansNom	EC	None
Pipp	CV	None
Pippa	AO	AO2
Pippin	A	A1
Pippin15	JA	None
Pippy	F	F1
Pipsqueak	B	B1
Pipsqueaks	N	None
Pirate	BU	None
Piro94	A	A2
Pisa4	K	K1
Pistachio	A	A3
Pita2	A	A1
PitaDog	AK	None
Pitbull	FQ	None
Pivoine	C	C1
Pixelle	AZ	AZ1
Pixie	K	K3
Placalicious	B	B1
Plagueis	G	G1
Plata	B	B1
Platte	ED	ED1
Pleakley	CR	CR5
Pleione	C	C1
Plmatters	B	B1
PLot	D	D1
Plumbus	F	F1
Pmask	A	A6
PMC	F	F1
Pocahontas	A	A3
Pochacco	GK	None
Pocket	EA	EA1
Poco6	CC	None
Podrick	B	B1
Poenanya	F	F1
Pointis	AP	AP2
Poise	S	None
Pokerus	K	K1
PokyPuppy	CS	CS2
Poland	CS	CS2
Policronamos	E	None
Polka	AS	AS2
Polka14	F	F1
Polkaroo	P	P1
Pollux	CY	CY1
Polly	CZ	CZ1
Pollywog	F	F1
Polo2Bam	F	F1
Polymorphads	A	A4
Polyphemus	A	A6
Polyyuki	CR	CR6
Pomar16	A	A2
Pondwater	EE	None
Pons	CT	None
Ponzi	Singleton	None
Poochiewood	L	L1
Poompha	A	A10
Popcicle	A	A3
Popper	FF	None
Pops	B	B1
PopTart	F	F1
Popy	BI	BI1
PoRanda	EE	None
Porcelain	J	None
Porky	E	None
Portcullis	DC	DC1
Posh	CY	CY4
Poster	B	B4
PotatoChip	EN	None
Potatoes	AK	None
PotatoSplit	A	A3
PotPie	CT	None
Potter	B	B1
Potty	EF	None
Poultress	EF	None
Pound	J	None
Poushou	EO	None
Powelldog	AW	None
Power	A	A2
Powerball	CZ	CZ4
Powerpuff	AZ	AZ1
Prager	D	D1
Prairie	FH	None
PrairieDogTown	FO	None
Preamble	AK	None
Predator	H	H1
Priamo	A	A6
Prickles	B	B1
Primadonna	C	C1
Prinashe11	A	A5
Prince	B	B4
PrinceCharming	B	B2
PrincePatrick	CV	None
PrincePhergus	EA	EA4
PrincessTrina	AR	None
Pringar	S	None
Priscilla	F	F1
Prithvi	K	K1
Priya	A	A9
Procrass1	BU	None
ProfessorX	B	B1
ProfFrink	AW	None
ProMouse	A	A1
Prophecy	JB	JB1
Prospero	AN	None
Provolone	BD	BD3
Prudy	A	A2
PSirce	EA	EA2
PSonyx	EQ	None
PSullivan	A	A1
Psycho	K	K5
PsychoKiller	CT	None
Pterodactyl	AK	None
Publix	EE	None
Pucara	FA	None
Puddles3	EE	None
PuffyCat	EE	None
Puginator	BD	BD2
Puhltonio	B	B1
Puissant	H	H1
Pukovnik	A	A2
Pulchra	EC	None
PullumCavea	DC	DC1
Pumancara	AK	None
Pumbaa	A	A4
Pumpernickel	GD	GD4
Pumpkin	E	None
Pumpkins	AZ	AZ1
PumpkinSpice	BE	BE2
Pupper	DO	None
Puppers	CD	None
Puppy	A	A3
PuppyEggo	EA	EA1
PurduePete	C	C1
Pureglobe5	AP	AP2
Purgamenstris	N	None
Purky	P	P6
PurpleHaze	A	A3
Pygmy	P	P1
PYPDinur	L	L4
Pytheas	CY	CY3
pZL12	Singleton	None
QBert	C	C1
QMacho	EB	None
Qobbit	A	A9
QTRlifeCrisis	A	A1
QuadZero	EA	EA5
Quaker	EE	None
Quallification	E	None
Quammi	EG	None
Quantum	BM	None
Quaran19	BE	BE2
Quartz	EA	EA10
Quasar	CT	None
Quasimodo	C	C1
Quby	L	L4
QueenB2	A	A2
QueenBeane	B	B1
QueenBeesly	A	A2
QueenBey	BU	None
QueenHazel	I	I1
QueenPie	B	B4
Quenya	EB	None
Quesadilla	B	B9
Quhwah	EC	None
Qui	FK	None
QuickMath	F	F1
Quico	F	F1
QuincyRose	K	K1
QuinnAvery	FF	None
QuinnKiro	A	A3
Quisquiliae	B	B1
Quokka	A	A2
Qyrzula	B	B2
R4	BD	BD2
Rabbitrun	DU	DU2
Rabbs	G	G1
Rabinovish	C	C1
Raccoon	EA	EA1
Racecar	FC	None
Rachaly	A	A2
Rachella	EF	None
RadFad	AY	None
Radiance	F	F1
Raela	S	None
RagingRooster	B	B3
Rahalelujah	A	A9
Rahel	C	C1
Rahul	CW	CW2
Raid	A	A1
Rainydai	BI	BI4
RainyPolka	BG	None
Rajelicia	A	A1
Rakim	E	None
Raleigh	BC	BC2
Ramen	K	K1
Ramiel05	EC	None
Ramsey	F	F1
Rana	BD	BD1
Ranch	DV	None
RanchParmCat	CT	None
Rando14	K	K5
Ranunculus	AP	None
RAP15	AK	None
Raphaella	AY	None
Rapheph	EA	EA1
Raptor	EA	EA1
Rapunzel97	K	K1
Raqqa	AY	None
Rasovi	EJ	None
Rasputia	GC	None
Rasputin	CA	None
Rattail	AS	AS3
Raunak	AW	None
RavenCo17	CZ	CZ8
RavenPuff	BI	BI2
RawrgerThat	B	B4
Raymond7	N	None
RayTheFireFly	DB	None
RazorC	DV	None
RazzB	AP	AP2
Razzleberry	JB	JB1
RcigaStruga	AK	None
Rearden	J	None
Reba	A	A3
Rebel	N	None
Rebeuca	A	A10
Red305	L	L3
RedBaron	CT	None
RedBear	BD	BD1
RedBird	F	F1
Redfield	EA	EA1
RedFox	AS	AS3
Redi	N	None
RedMaple	B	B1
Redno2	J	None
RedRaider	CR	CR3
RedRaider77	S	None
RedRock	A	A2
RedWattleHog	DX	None
Reedo	AZ	AZ1
Refuge	A	A12
Regigigas	BI	BI4
ReginaGlobina	FC	None
RegnumDei	CF	None
Reindeer	M	M1
Relief	A	A4
Rem711	Z	None
ReMo	A	A15
RemRem	CS	CS2
Remus	A	A15
RemusLoopin	BB	BB2
Remy19	G	G1
Renaissance	G	G1
Renaldo	AU	AU6
Renaud18	F	F4
RenegadeRaider	EA	EA4
Renna12	AS	AS3
Renzie	EA	EA1
Reprobate	B	B5
Reptar3000	K	K4
REQ1	CF	None
REQ2	Singleton	None
REQ3	Singleton	None
RER2	CA	None
ResDef	A	A3
RetrieverFever	BF	None
Retro23	A	A2
RexFury	CA	None
Rey	M	M2
Reyja	DY	None
Reynauld	Singleton	None
RGL3	CA	None
Rhinoforte	B	B2
Rhodalysa	CA	None
Rhogar	EE	None
Rhynn	A	A1
RhynO	A	A10
Rhysand	EE	None
Rialto	F	F1
Ribeye	DE	DE1
Rich	B	B5
Richie	AY	None
Richo	K	K1
Rickmore	DJ	None
RickRoss	BO	None
RicoCaldo	EK	EK2
Ricotta	B	B1
Rideau	BF	None
RidgeCB	A	A1
Rie18	EF	None
Rifter	A	A6
Riggan	B	B1
Rikishi	BE	BE2
RikSengupta	EF	None
Rileysaurus	BU	None
Rima	BI	BI1
Rimmer	E	None
Rimu	B	B1
Ringer	A	A1
Rings	AQ	None
Rinkes	B	B9
Riovina	AK	None
Riparian	R	None
Riptide	BE	BE1
Rita	F	F1
Rita130	B	B5
Rita1961	B	B3
RitaG	F	F1
Riverdale	AK	None
RiverMonster	E	None
RiverRaider	DE	DE1
Riverton	B	B1
Riyhil	EA	EA1
Rizal	C	C1
Rizwana	AP	AP1
RoadKill	DE	DE3
Roary	A	A8
RobinRose	EG	None
Robinson	EA	EA1
RobinSparkles	CX	None
RobsFeet	EC	None
Robyn	B	B1
Rocha	C	C1
Rockabye	FC	None
RockieBear	A	A4
Rockne	F	F1
RockScotty	AZ	AZ5
Rockstar	A	A3
RockyHorror	F	F1
Rofo	DE	DE1
Rog141	EA	EA1
RogerDodger	DC	DC1
Rohr	A	A1
Roksolana	A	A6
Roliet	B	B1
Rollins	EB	None
RoMag	C	C1
Roman	ED	ED1
RomansRevenge	Singleton	None
RomaT	B	B3
Romero	BF	None
Romm	EG	None
Romney	A	A4
Rona	EB	None
Ronaldo	DP	None
Ronan	C	C1
Roney	DJ	None
Ronnie	AN	None
RonRayGun	T	None
Rooney	BN	None
Roosevelt	A	A4
Root	Singleton	None
RootBeer	FA	None
Rooter	FB	None
Roots515	C	C1
Rope	R	None
Rosa24	A	A4
RosaAsantewaa	BI	BI2
Rosalind	A	A15
Roscoe	B	B1
RoscoWindex	EE	None
Rose5	L	L1
Rosebush	B	B2
RoseMarie	M	None
RosePharie	BF	None
RosieMae	EA	EA1
RosiePosie	AR	None
Rosmarinus	K	K1
Rossetti	L	L2
Rowa	BL	None
Rowdy	A	A10
Rowlf	EG	None
Roy17	B	B1
RoyalG	CS	CS2
Royals2015	F	F1
Rozby	AK	None
RRH1	Singleton	None
Rubeelu	N	None
Rubeus	A	A1
Ruby	F	F1
RubyRalph	EG	None
Ruchi	AS	AS1
Rudy	EG	None
Rufus	A	A1
Ruin	A	A4
Rumi	DV	None
Rummer	A	A3
Rumpelstiltskin	L	L2
Runhaar	DJ	None
RunningBrook	ED	ED2
Ruotula	A	A1
Rusticus	BD	BD1
RustyBoy	AW	None
Rutherferd	A	A1
Ruthiejr	K	K4
Ruthy	DW	None
Ryadel	O	None
Ryan	FF	None
RyeScarlet	A	A9
Saal	F	F1
Sabbb	F	F1
Sabella	B	B2
Sabertooth	A	A4
Sabia	A	A3
Sabinator	A	A3
Sabourin	AZ	AZ5
Sachima	A	A9
Sadboi	DV	None
SadLad	EG	None
Saftant	BD	BD3
Sage7	EE	None
Sagefire	A	A1
Saguaro	B	B7
Sahara	CZ	CZ2
Saints25	E	None
Saintus	A	A8
Sakai	AY	None
Salacia	C	C1
Salete	BG	None
Salgado	AL	None
Salk	AW	None
SallyK	EG	None
SallySpecial	DM	None
SaltySpitoon	BE	BE2
Salvador	DC	DC1
Salz	A	A11
Sam12	CS	CS2
Samaymay	B	B1
Samba	CV	None
Samisti12	BE	BE1
Samman98	CZ	CZ4
Samora	BB	BB1
Sampson	DE	DE4
Sampudon	DV	None
SamScheppers	K	K4
Samty	L	L3
SamuelLPlaqson	K	K1
SamW	EP	None
Samy	Singleton	None
SanaSana	EB	None
Sandaddy	A	A1
Sandalphon	F	F1
Sandman	AN	None
Sangak	BI	BI2
Sanjuju	DE	DE1
Sansa	EA	EA2
SansAfet	EB	None
SantasSleigh	EE	None
Santhid	DY	None
Sanya	A	A1
Saphira	AN	None
Sapo	DA	None
Sara	EE	None
SarahRose	BD	BD1
Saratos	EA	EA2
SarBear	EB	None
SarFire	A	A1
Sarge	FB	None
Sarkar	BM	None
Sarma624	F	F1
Saronaya	DE	DE1
Sarshaun	L	L2
Sashimi	AY	None
Saskia	A	A11
Sassafras	F	F1
Sassay	E	None
SassyB	F	F1
SassyC	BN	None
SassyCat97	B	B1
Satis	BM	None
SaturnRing	A	A3
Sauce	C	C1
Savage	CZ	CZ2
Savage2526	AK	None
Savannah	EC	None
Savbucketdawg	DC	DC1
Sbash	I	I2
SBlackberry	EJ	None
Scamander	EE	None
Scamp	A	A4
Scap1	BI	BI2
ScarletRaider	DQ	None
Scarlett	K	K1
Scavito	AR	None
SCentae	DO	None
Schadenfreude	B	B1
Schaffner	AZ	AZ1
Schatzie	J	None
Scheme	BE	BE1
Scherzo	A	A9
Schiebel	G	G1
Schiebs	CW	CW3
Schimmels22	EA	EA11
Schism	FF	None
Schlegelian	BP	None
Schmidt	CU	CU4
Schnabeltier	DB	None
Schnapsidee	EA	EA1
Schnauzer	N	None
Schomber	DQ	None
SchoolBus	O	None
SchottB	DE	DE1
Schubert	EA	EA8
Schueller	B	B1
Schuy	O	None
Schwartz33	DJ	None
ScienceWizSam	AU	AU1
Scioto	DE	DE4
Scissor2024	EA	EA11
Scitech	N	None
ScoobyDoobyDoo	C	C2
Scoot17C	B	B1
Scorpia	A	A5
Scotia	FO	None
Scottish	F	F1
ScottMcG	C	C1
SCoupsA	GE	None
Scout	A	A3
Scowl	A	A1
Scrick	B	B1
Scruffy	EM	EM1
Scrunchy	EE	None
Scuba	CR	CR5
Scumberland	EC	None
Scuttle	AK	None
SDcharge11	B	B1
Seabastian	F	F1
Seabiscuit	A	A1
Seagreen	F	F1
Seahorse	AY	None
Seanderson	A	A1
SeaWolves	EE	None
Sebastisaurus	BB	BB2
Sebata	C	C1
Secretariat	DJ	None
Sedgewig	EA	EA1
Sedona	DE	DE1
Sejanus	AD	None
Sekhmet	CZ	CZ4
Seldom	FD	None
Selr12	B	B1
Selwyn23	EC	None
SemperFi	A	A2
Send513	R	None
SendItCS	BI	BI4
SenorClean	A	A4
Sephiroth	DU	DU1
Serenabean	JA	None
Serendipitous	B	B5
Serendipity	B	B1
Serenity	A	A2
SeresaTree	BK	BK1
Sergei	AK	None
SerialPhiller	AN	None
Serpentine	B	B1
Settecandela	AA	None
Seume	AN	None
Severus	A	A10
SG4	F	F1
SgtBeansprout	K	K1
ShaboiShabazz	G	G1
Shaboozey	J	None
Shade	AO	AO2
Shadow1	K	K6
ShaggyRogers	DJ	None
Shagrat	CF	None
ShaiHulud	EA	EA1
Shaka	A	A4
ShakeItOph	AZ	AZ4
ShakeNBake	BN	None
Sham	BK	BK1
Sham4	A	A11
Shambre1	Singleton	None
Shamu	EA	EA2
ShamWow	E	None
Shaobing	K	K1
Shapes	A	A10
Shaqnato	C	C1
Sharkboy	EB	None
Shatter	DR	None
Shauna1	F	F1
ShawBrad	DN	DN1
Shawty	BB	BB1
Shayna	EB	None
ShayRa	A	A15
SheaKeira	A	A9
SheckWes	CT	None
ShedlockHolmes	K	K3
Shee	EA	EA1
Sheen	A	A7
Sheila	B	B1
SheldonCooper	A	A4
Shelley	CS	CS3
Shelob	C	C1
Shenandoah	B	B3
Sheng711	L	L4
Shenyu	B	B5
Shepard	AU	AU2
SheRa	BI	BI2
ShereKhan	E	None
ShiaLabeouf	C	C1
ShiaSurprise	K	K1
Shiba	AW	None
Shida	O	None
Shifa	C	C1
ShiLan	F	F1
Shinji	DC	DC1
Shipwreck	P	P1
ShiVal	B	B1
Shivanishola	DE	DE1
Shlim410	CZ	CZ4
Shnickers	C	C1
Shocker	Singleton	None
ShortQueendom	A	A1
Shotgun	EC	None
ShowerHandel	F	F1
Shoya	FB	None
Shrew	Singleton	None
Shrimp	C	C1
ShrimpFriedEgg	N	None
ShroomBoi	F	F1
Shrooms	AL	None
Shrubaron	EC	None
Shuckle	BE	BE1
Shukran	AY	None
Shuman	CA	None
Shweta	N	None
Shyg	BC	BC4
Shygu2	A	A4
ShyRosie	EK	EK2
Sibs6	A	A1
Sicarius2	AO	AO2
Sidious	CZ	CZ7
Sienna	DG	DG1
Sigman	B	B1
SilentRX	AP	AP4
SilentWarrior	EF	None
Sillytadpoles	EG	None
Silvafighter	N	None
SilverBell	B	B1
SilverChicken	F	F2
SilverDipper	C	C1
Silverleaf	L	L1
Silvy	N	None
Simielle	B	B1
Simpliphy	E	None
Simpson	AZ	AZ1
SimranZ1	F	F1
Sinatra	EA	EA4
Sippinontea	EE	None
SirBeauregard	B	B1
SirDuracell	E	None
SirFrank	EC	None
SirHarley	D	D1
SirJeffery	B	B5
SirPhilip	K	K6
SirVictor	EA	EA4
SiSi	F	F1
Sisko	DR	None
Sitar	DE	DE1
Sixama	DS	None
Sizemore	G	G1
SJay	EA	EA1
SJReid	FC	None
Skelbel	AZ	AZ1
SketchMex	CT	None
Skinny	M	M1
SkinnyPete	N	None
Skipitt	A	A4
SkiPole	A	A1
Skippy	B	B1
Skitty	FQ	None
SKKY	BU	None
Sknot	A	A2
Skog	DO	None
Skylord	EB	None
Skysand	CR	CR3
Slagathor	A	A1
Slarp	K	K4
Slatt	B	B1
Slay	EB	None
Sleepyhead	Singleton	None
Slentz	EE	None
Slim	F	F1
SlimJimmy	M	M1
Slimphazie	K	K1
SlippinJimmy	B	B3
Slizam	EE	None
Sloopyjoe	AW	None
SlySloth	EG	None
Smairt	A	A1
SmallFry	C	C1
Smarties	EC	None
Smeadley	A	A8
Smeagan	A	A2
Smeagol	A	A1
Smelly	GK	None
SmellyB	A	A6
Smilerella	GH	None
SmokingBunny	DC	DC1
Smooch	O	None
Smoothie	CQ	CQ1
Smurph	N	None
Snakehole	EF	None
Snape	A	A11
SnapTap	A	A2
Snazzy	A	A1
Sneeze	G	G1
Snek	AZ	AZ3
Snekmaggedon	N	None
Snenia	L	L3
Snickers	A	A3
Snorlax	BD	BD1
Snuffles	EE	None
Soap141	L	L2
Socotra	CT	None
Softsoap	EB	None
SoilAssassin	CZ	CZ2
SoilDragon	A	A3
Soile	B	B1
SoilGremlin	EA	EA1
SoJo	BC	BC1
SoJulia	L	L2
Solea	EB	None
Solid	BU	None
Sollertia	BE	BE2
Solon	A	A1
Solosis	B	B1
Sombrero	CS	CS2
Sonah	P	P1
Sonali	FG	None
Sonny	AO	AO2
SonOfLevi	EA	EA1
Soondubu	AZ	AZ6
Soos	CP	None
Sooty	AZ	AZ5
Sopespian	CT	None
Sophia	B	B1
SophKB	E	None
SorJuana	AQ	None
SororFago	A	A14
Sorpresa	A	A1
SoSeph	K	K5
Soshari	A	A3
Soshi	BI	BI1
Soto	B	B1
Sotrice96	E	None
Soul22	F	F2
Soups	A	A15
Sour	DR	None
Sourignavong	AN	None
South40	BD	BD1
SoYo	A	A3
Sparcetus	EF	None
Sparkdehlily	F	F1
SparkleGoddess	BK	BK1
Sparky	AF	None
Spartacus	F	F1
Spartan300	B	B1
Spartoi	Singleton	None
Sparxx	A	A4
SPB78	BA	None
Spec	C	C1
SpecialK	AZ	AZ5
Specks	C	C1
Spectropatronm	BI	BI1
SpeedDemon	DL	None
Speedwell	BD	BD3
Spelly	BE	BE2
SpicyFrank	AY	None
Spiderbri	GK	None
Spike509	A	A3
SpikeBT	A	A1
Spikelee	F	F1
Spilled	BE	BE2
Spinach	N	None
Spino	A	A4
Splinter	CU	CU1
Spock	K	K1
Spocter	BQ	None
SpongeBob	N	None
Spooks	BT	None
Spooky	DN	DN2
Spoonbill	F	F1
Sporto	AW	None
Spouty	A	A9
Sprinklers	C	C1
Sproutie	CZ	CZ2
Spud	C	C1
Sputnik	AX	None
Squall	JB	JB1
Squash	EG	None
SqueakyClean	BD	BD2
Squee	A	A1
Squibbles	CS	CS2
Squid	B	B1
Squiddly	DN	DN2
Squiggle	B	B1
Squillium	BE	BE1
Squint	J	None
Squircle	EB	None
Squirty	F	F3
SrishMeg2525	C	C1
Sros11	BA	None
StAB	EP	None
StagePhright	EK	EK2
Stagni	A	A3
Stanimal	BE	BE2
Stank	E	None
Stanktossa	EA	EA1
StAnnes	F	F1
Stap	F	F1
Starbow	BE	BE2
Starburst	CT	None
Starcevich	F	F1
Stargaze	G	G5
Stark	E	None
StarLord	AW	None
StarPlatinum	BE	BE2
StarStruck	CR	CR2
StarStuff	A	A2
Stasia	A	A4
Statler	EG	None
StAugustine	AI	None
Stayer	AW	None
StCroix	CA	None
SteamedHams	CT	None
Steamy	A	A12
Stella	BF	None
StellaBean	E	None
Stem	EE	None
StephanieG	C	C1
Stephig9	A	A8
StepMih	A	A3
SteveFrench	CS	CS2
StevieBAY	AO	AO2
StevieRay	P	P1
StevieWelch	ED	ED2
StewieG	A	A1
StewieGriff	AN	None
Sticker17	CS	CS3
Stickynote	EN	None
Stigma	BK	BK1
Stiles	EP	None
Sting	CP	None
Stinger	B	B4
StingRay	EA	EA1
Stink	A	A4
StinkyVeggy	B	B5
Stinson	K	K1
StirfryIV	EA	EA1
STLscum	A	A1
StolenFromERC	E	None
Stoor	EB	None
Stormageddon	DX	None
Stormborn	BU	None
Stormbreaker	EK	EK1
Stormbreaker8	EA	EA1
StormChicken	E	None
Stormer	DV	None
StorminNorm	DE	DE1
Strathdee	EA	EA1
Stratus	AN	None
StrawberryJamm	EG	None
StrepC	BD	BD5
StressBall	P	P1
Strobilo	K	K2
Strokeseat	F	F1
Stromboli	EB	None
StrongArm	A	A1
Strosahl	A	A15
Struggle	B	B1
StuartMinion	AS	AS3
Stubby	C	C1
StubbySaigey	C	C1
Stuck	I	I2
Stuff	BH	None
Stultus	DE	DE1
Stuu	AZ	AZ5
Subaru	AZ	AZ1
Success	BT	None
Sucha	EJ	None
Sue2	AZ	AZ1
Suerte	CZ	CZ4
Suffolk	B	B1
Suigeneris	B	B5
Sujidade	BD	BD1
Sukkupi	CR	CR4
Sulley	K	K1
Sultana	A	A4
SummitAcademy	CT	None
SuMoo	EH	None
Sumter	A	A1
Sunfish	Singleton	None
Sunflower1121	K	K6
Sunhee	A	A14
Sunny	EC	None
Sunny4976	FI	None
SunnyD	EB	None
SunsetPointe	BD	BD1
Sunshine23	FG	None
Sunshine924	A	A1
Supakev	AK	None
SuperAwesome	A	A6
SuperCallie99	A	A6
Superchunk	A	A2
Superfresh	EA	EA1
SuperGrey	F	F1
Supernova	BU	None
Superphikiman	J	None
SuperSonics	U	None
Superstar	BD	BD2
SuperSulley	CR	CR2
Suppi	AK	None
Surely	B	B1
Survivors	CT	None
Suscepit	CZ	CZ1
Sushi23	BE	BE1
Suzy	DG	DG1
SV1	BC	BC1
SVoro	C	C1
SwagPigglett	F	F1
SwainyDoc	B	B3
Swann	CA	None
SweatNTears	CT	None
Sweetclover	JA	None
SweetiePie	A	A2
Sweets	G	G1
Swenson	AN	None
Swervy	EB	None
Swim	FD	None
Swiphy	B	B1
Swirley	A	A5
SwirlSquare	A	A2
Swish	B	B1
SwissCheese	A	A1
SwissCheezer	EK	EK1
Switzer	A	A1
Switzerland	A	A15
Swole	A	A1
SydNat	A	A5
Syleon	DU	DU1
Symere	EA	EA1
Synepsis	AU	AU1
SynergyX	B	B3
Syra333	K	K6
TA17A	B	B2
Tachez	K	K1
TaeYoung	AO	AO2
TagePhighter	BD	BD1
Taheera	G	G1
TaidaOne	BI	BI1
TailX7	ER	None
Tainan	C	C1
TaiwanKao	K	K1
Taj	F	F1
Taj14	AN	None
Takoda	CA	None
Talia1610	FC	None
Tallboi	AZ	AZ1
TallGrassMM	B	B1
Talon44	DJ	None
Talos	BS	None
Tandem	ED	ED1
Tangent	DE	DE1
Tangerine	DE	DE1
Tanis	DJ	None
Tank	AP	AP1
Tapioca	N	None
Taptic	W	None
Taquarus	A	A4
Taquito	K	K4
Tardus	DE	DE4
Targaryen	BE	BE1
Target	A	A1
Tarkin	E	None
TaronosaurasRx	DB	None
TarsusIV	A	A2
Tarynearal	A	A5
Tarzan	DY	None
Tasp14	A	A1
Tatanka	AU	AU1
TatarkaPM	EA	EA1
TattModd	AK	None
Taurus	A	A3
TaylorSipht	AS	AS1
Tayonia	CZ	CZ1
TBond007	K	K3
Tbone	AZ	AZ1
TBrady12	E	None
TChen	F	F4
Tchotchke	F	F1
TClif	K	K6
TDanisky	F	F1
Teacup	AU	AU1
Teagan	EA	EA1
Teagster	EB	None
Teal	CS	CS3
Teamocil	EC	None
Teardrop	C	C1
TeardropMSU	E	None
Teaspoon	E	None
Teatealatte	CS	CS4
Techage	P	P1
TeddyBear	EA	EA1
TeddyBoy	EE	None
Tedro	EF	None
Teech	CS	CS4
Teehee	EG	None
Teejan	K	K1
Tefunt	BD	BD2
TelAviv	O	None
Telesworld	B	B1
Temper16	AK	None
Tempo	EG	None
Temprado	A	A6
TenaciousP	DJ	None
Tenda	EA	EA1
Teng	GF	None
Tenney120	AU	AU6
Tenno	AU	AU1
Teodoridan	A	A1
Terapin	DG	DG1
Terij	EI	None
Terminus	E	None
Terrific	A	A2
Terror	G	G1
Tesla	S	None
Teutsch	BE	BE1
Texage	A	A3
TforTroy	AZ	AZ1
TG1	BB	BB1
Thanksgivukkah	A	A4
ThankyouJordi	CZ	CZ1
Thatch	JB	JB2
ThayneTheZag	AY	None
Theia	A	A5
TheloniousMonk	A	A1
Theresita	EA	EA7
Thespis	P	P1
Thestral	BD	BD2
ThetaBob	F	F4
Thibault	J	None
Thimann	CZ	CZ4
Thimble	E	None
Thing3	DE	DE1
Thiqqums	BI	BI4
ThirteenKH	EK	EK2
Thompsone	EA	EA1
Thonko	B	B8
Thor	A	A1
Thora	B	B1
Thorongil	EA	EA1
Thoth	D	D1
ThreeOh3D2	B	B1
ThreeRngTarjay	J	None
Thresher	E	None
ThulaThula	P	P5
Thumb	H	H1
Thunderbird	B	B1
Thunderclap	AQ	None
Thyatira	K	K5
Tiamoceli	DE	DE3
Tian	AZ	AZ1
TicTac	EK	EK1
TieDye	BI	BI1
Tierra	K	K6
Tiff81	AY	None
Tiffany	A	A3
Tiger	A	A5
Tillicus	DV	None
Tillums	FD	None
TillyBobJoe	DC	DC1
Timinator	AO	AO2
Timmi	B	B1
TimoTea	EE	None
Timothy	A	A11
Timshel	A	A7
TimTam	CZ	CZ1
TinaBelcher	BD	BD2
TinaBug	G	G1
TinaFeyge	A	A4
TinaLin	CU	CU1
Tinciduntsolum	B	B2
TingHuaYa	K	K1
TiniBug	K	K1
TinoCrisci	AN	None
TinSulphur	EA	EA1
Tinybot	A	A4
TinyDot	Singleton	None
Tinyman4	EA	EA11
TinyMiny	EF	None
TinyPebbles	A	A3
TinyTerror	B	B3
TinyTim	C	C1
TinyTimmy	A	A11
TinyTimothy	EK	EK1
TinyTruffula	EE	None
TipsytheTRex	A	A2
Tiri	K	K1
TiroTheta9	A	A4
Tissue	EG	None
TJE1	Singleton	None
TM4	K	K2
TMaxx	FR	None
TNguyen7	A	A3
Toad24	AS	AS1
Toaka	A	A9
Toast	CV	None
ToastyFinz	BC	BC1
Todacoro	A	A3
Togo	DC	DC1
Tokki	AU	AU2
Tolls	CT	None
Toma	BD	BD1
Tomas	BE	BE2
Tomaszewski	E	None
Tomathan	A	A2
TomBombadil	B	B1
TomBrady	G	G1
TomBrady12	EE	None
Tomlarah	B	B1
TomSawyer	BE	BE2
Tonenili	C	C1
Toneprano	DQ	None
ToneTone	A	A6
Tongui	EF	None
Toni	B	B1
Toniann	CQ	CQ1
Tonitrus	Singleton	None
TonyStarch	BI	BI1
TooFast2Furius	B	B1
Tooj	B	B1
TootsiePop	F	F1
Tootsieroll	F	F1
Topanga	A	A10
Topgun	A	A1
Tophat	AR	None
Topiatin	F	F1
Topper	K	K1
ToriToki	BF	None
Toro	A	A7
Toron	F	F6
Torres	K	K1
Tortellini	P	P2
Tortoise12	N	None
Tortoise16	C	C1
Tote	A	A1
Totinger	F	F1
Toto	E	None
TouchMeNot	EO	None
Toulouse	AN	None
Tourach	L	L2
Towmatter	DL	None
TownLake	EK	EK1
TP1604	BG	None
TPA2	Singleton	None
TPA4	Singleton	None
TpudiCK	M	M1
Traaww1	E	None
Tracker	CR	CR2
Trackstar	EE	None
TraderJ	DR	None
Traft412	A	A1
Transit	JB	JB2
Trapezoid	JB	JB1
Travvers	A	A2
Trax	DU	DU2
Treat	BF	None
Treddle	A	A1
Tredge	CS	CS4
Tres	B	B2
TreyKay	K	K1
Triad	B	B1
Tribby	AM	None
TribleTrouble	K	K3
Tribute	BE	BE1
Trice	K	K1
TriFive	L	L3
Trike	A	A10
Trina	CE	None
Trine	CD	None
Trinitium	C	C1
Tripl3t	A	A1
TripleJ	FJ	None
TrippleS	EK	EK2
Trireme	EE	None
Triscuit	GG	None
Tristan	A	A2
Triste	BD	BD1
Triumph	BD	BD2
Trixie	A	A2
TrixiePhattel	AU	AU6
Trogglehumper	Singleton	None
Troje	CT	None
Troll4	D	D1
Trooper	A	A2
Trouble	A	A1
Troy	EP	None
TroyPia	A	A4
Truckee	AU	AU5
True	B	B1
Trufflozitus	DJ	None
TruffulaTree	K	K1
Trumpet	CZ	CZ1
Truong	EK	EK2
Trustiboi	AU	AU1
TrvxScott	BD	BD2
Trypo	B	B1
TuanPN	BD	BD1
Tubberson	BC	BC1
Tubs	A	A9
Tuck	AZ	AZ1
Tucker	A	A6
Tuco	E	None
TuertoX	CZ	CZ2
TukTuk	EB	None
TunaTartare	BK	BK1
Turab	AZ	AZ1
Turbido	A	A2
TurboVicky	EJ	None
Turj99	A	A1
TurkishDelight	Singleton	None
Turret	C	C1
Turuncu	CR	CR1
Tutumahutu	AZ	AZ1
TWAMP	CA	None
Tweety	F	F1
Tweety19	AZ	AZ3
Twigg	A	A5
Twin	DQ	None
Twinkle	CZ	CZ4
Twister	A	A10
Twister6	DC	DC1
Twitch	K	K1
TwoBits	EA	EA5
Twonlo	DE	DE3
TwoPeat	A	A1
Tycho	DE	DE1
TyDawg	M	M1
Tydolla	B	B3
TygerBlood	A	A4
Tyke	C	C1
TymAbreu	AN	None
Typha	Y	None
Typher	EJ	None
Typhonomachy	CT	None
TyrionL	B	B1
Tyrumbra	EC	None
Tyson	L	L1
TZGordon	CU	CU1
U2	A	A1
UAch1	B	B1
UBSmoodge	DQ	None
Ubuntu	Q	None
Ugenie5	A	A9
UhSalsa	CA	None
Ukulele	E	None
Ulysses	A	A4
UmaThurman	CV	None
UncleHowie	B	B1
UncleRicky	F	F1
Underpass	L	L2
Unicorn	K	K6
UnionJack	A	A5
Unphazed	EK	EK1
Unstoppable	BD	BD1
Untouchable	DJ	None
UNTPL	BH	None
Updawg	A	A2
UPIE	L	L1
Upsilon	EE	None
Upyo	CD	None
Urkel	K	K1
Urla	AK	None
Urza	BD	BD6
Usavi	B	B1
Utopia	FE	None
Utz	CV	None
UtzChips	EH	None
Uzumaki	AU	AU6
VA6	A	A2
Vagabond	O	None
Vaishali24	B	B1
Valary	DC	DC1
ValentiniPuff	Singleton	None
Validus	K	K1
Valjean	B	B1
Vallejo	AK	None
ValleyTerrace	C	C1
VanDeWege	DC	DC1
Vanisius	EE	None
Vanisoa	A	A9
VanLee	KA	None
Vanseggelen	BD	BD3
Vardy	DJ	None
Vasanti	CZ	CZ2
Vash	BB	BB1
VasuNzinga	S	None
Vaticameos	B	B1
VC3	A	A2
Velene	EA	EA1
Veliki	K	K1
Velveteen	F	F1
Vendetta	CU	CU1
Venti	P	P1
Verabelle	BD	BD3
Veracruz	A	A3
Veritas	B	B1
Verity	DE	DE4
Verse	BD	BD3
Veteran	F	F1
Vetrix	L	L2
ViaConlectus	DE	DE4
Vibaki	FL	None
Vic9	B	B2
Viceroy	EG	None
Vidya	P	P1
VieEnRose	BD	BD6
Vincenzo	B	B4
Vine	CT	None
Violac	F	F1
Violet	A	A1
Violeta	GA	None
VioletZ	B	B4
Virapocalypse	B	B1
Virgeve	B	B1
Virizion	BN	None
Visconti	D	D1
Vispistious	EA	EA1
Vista	B	B1
Vitaenoii	CS	CS4
Vitas	EB	None
VitulaEligans	EE	None
Vitus	FL	None
Vivaldi	B	B1
Vivi2	DE	DE1
ViviJ	K	K5
Vivum	F	F1
Vix	A	A3
VohminGhazi	A	A6
Volt	DP	None
Vondra	BP	None
Vopal	AY	None
Vordorf	DT	None
Vorrps	O	None
Vortex	B	B1
Vorvolakos	BF	None
VRedHorse	F	F1
VResidence	AZ	AZ1
VroomVroom	AZ	AZ4
Vulpecula	AS	AS1
Vulture	AK	None
VWB	BA	None
Wachhund	F	F1
WaddleDee	FC	None
Waits	A	A15
Wakanda	BK	BK2
WaldoWhy	D	D1
Waleliano	B	B4
WalkingDead	EB	None
Wallhey	B	B1
Wally	C	C1
Walrus	CV	None
WalterMcMickey	A	A10
Waltz	AL	None
Wamburgrxpress	L	L1
Wanda	J	None
Wander	A	A4
Warda	AZ	AZ1
Wardwill	EA	EA5
Warpy	BE	BE1
Warren	GA	None
Warrior24	A	A15
Waterdiva	B	B1
Waterfoul	K	K5
Waterlily	EK	EK2
Watermelon	A	A1
Watermoore	BE	BE1
WaterT	GB	None
Watson	A	A3
Wawa	AK	None
Wayne	AK	None
Wayne3	EG	None
Weasels2	CB	None
Webster2	Q	None
Wee	F	F1
Weher20	B	B1
WeiHuaDA	A	A2
Weirdo19	AH	None
Weiss13	R	None
Welcome	ED	ED2
WelcomeAyanna	CZ	CZ1
Wendigo	G	G1
Wentworth	BN	None
Werner	BD	BD1
Wesak	EK	EK1
West99	B	B2
WestPM	EA	EA11
Westrich	AS	AS1
Westy	BK	BK1
Whabigail7	A	A2
Whack	Singleton	None
Whatever	BD	BD1
Whatsapiecost	F	F1
WheatThin	DI	None
WheeHeim	BO	None
Wheelbite	AL	None
Wheeler	A	A1
Wheelie	EG	None
Wheezy	CR	CR2
WhereRU	BE	BE1
Whirlwind	L	L3
Whiteclaw	CZ	CZ2
Whitney	DN	DN1
Whitty	T	None
WhoseManz	CR	CR4
Whouxphf	F	F1
Whytu	FE	None
WideWale	A	A2
Widow	CD	None
Wiggin	E	None
Wigglewiggle	L	L2
Wiks	A	A6
Wilbur	A	A4
Wilca	EG	None
Wildcat	V	None
Wilde	AP	AP1
Wilder	L	L2
Wildflower	O	None
WildNOut	EA	EA1
Wildwest	AZ	AZ1
Wile	A	A4
WileyE	AS	AS1
Wilkins	A	A1
Wilkos	BN	None
Willez	E	None
William	CV	None
WilliamBoone	CQ	CQ1
WilliamStrong	EA	EA6
Willis	C	C1
Willsammy	P	P1
WillSterrel	F	F1
Windest	AY	None
Windsor	B	B1
Winget	O	None
WinkNick	CZ	CZ4
Winky	L	L2
Wintermute	K	K4
Winzigespinne	EA	EA1
Wipeout	BE	BE2
Wishmaker	Q	None
Wisp	CV	None
Witch	EE	None
Wizard	DC	DC1
Wizard007	A	A4
Wizzo	BU	None
Wocket	CV	None
Woes	CS	CS3
Wofford	BE	BE2
Wogge42	O	None
Wojtek	DV	None
Wolfpack	EE	None
Wolfstar	ED	None
Wolfwood	CT	None
Wollypog	Singleton	None
Wolpertinger	A	A11
WonderBoy	AK	None
Wooldri	A	A3
Wooper	DR	None
Worcestershire	CS	CS2
WorldCup	A	A9
Wrackline	GF	None
WRightOn	BF	None
Wrigley	CY	CY4
WST1	AJ	None
WunderPhul	A	A6
Wyatt2	L	L1
Wyborn	AO	AO2
Wyvern	GJ	None
Xandras	E	None
Xavia	P	P3
Xavier	B	B1
Xebius	EA	EA2
Xena	A	A4
Xenia2	DV	None
Xeno	N	None
Xenomorph	AM	None
Xerxes	N	None
XFactor	F	F1
XianYue	A	A2
Ximenita	K	K6
Xincheng	B	B4
Xitlalli	EK	EK1
xkcd	E	None
Xkcd426	BG	None
Xula	I	I1
Yaboi	BE	BE2
Yafa	EK	EK2
Yago84	DR	None
Yahalom	B	B3
Yakult	CT	None
Yami	EE	None
Yang	AZ	AZ1
Yank	AN	None
Yappy	Singleton	None
Yara	BN	None
Yarn	CT	None
Yasdnil	BD	BD1
YasnayaPolyana	K	K4
Yassified	C	C1
YassJohnny	E	None
Yasuo	EE	None
Yavru	FE	None
YDN12	BG	None
Yecey3	A	A9
Yeet	J	None
Yeet412	CZ	CZ2
Yeezus	AQ	None
Yeezy	CZ	CZ3
YellowPanda	EK	EK1
Yelo	R	None
YemiJoy2021	C	C1
YertPhresh	EE	None
YesChef	AZ	AZ1
Yeshua	DR	None
Yeti	EC	None
Yikes	DV	None
Yinz	B	B3
Yndexa	CR	CR4
Yogi	CA	None
Yokurt	A	A6
Yoncess	CA	None
Yorick	F	F1
YorkOnyx	DE	DE1
YoSam321	A	A4
Yoshand	B	B1
Yoshi	F	F2
Yosif	BD	BD3
Yotsuba	JA	None
YouGoGlencoco	B	B1
Youngblood	E	None
YoungHarleezy	AY	None
YoungMoneyMata	C	C1
YoureAdopted	K	K1
Yubaba	EE	None
Yucca	C	C1
Yucky	CT	None
Yuma	ED	ED2
Yummy	CT	None
Yuna	K	K6
YungJamal	O	None
YungMoney	DC	DC1
Yunkel11	K	K1
YuuY	EA	EA10
Yvonnetastic	DD	None
Zabiza	K	K1
Zada	EA	EA1
Zagie	EG	None
Zaheer	FF	None
Zahlia	EE	None
Zaider	B	B1
Zainub	BD	BD2
Zaka	A	A6
Zakai	L	L2
Zakhe101	O	None
Zalkecks	C	C1
Zameen	CZ	CZ1
ZamZam	BD	BD3
Zanella	EJ	None
Zany	DV	None
Zapner	F	F2
Zarafa	A	A3
Zarbodnamra	CV	None
Zareef	CT	None
Zaria	L	L1
Zartrosa	AO	AO2
Zavala	K	K1
ZAYM	DB	None
Zayuliv	EA	EA5
Zebo	O	None
Zeeculate	A	A1
Zeenon	C	C1
Zeigle	BF	None
Zeina	AU	AU6
Zelda	B	B1
Zelink	J	None
Zemanar	B	B4
Zemlya	BD	BD1
Zenitsu	EA	EA2
Zenon	R	None
Zenteno07	B	B13
ZenTime222	T	None
Zeph	DJ	None
Zephyr	A	A1
Zepp	EA	EA5
Zerg	F	F1
Zeta1847	EH	None
Zetzy	A	A3
Zeuska	A	A1
Zhafia	EG	None
Zhengyi	EK	None
ZhongYanYuan	L	L2
Zhuangyuan	AS	AS2
ZiggyZoo	CV	None
Ziko	DP	None
Zilizebeth	P	P1
Zilla	CV	None
Zimmer	A	A12
Zion	EN	None
Zipp	DE	DE4
Zippen	AU	AU7
Zirinka	CZ	CZ1
Zitch	DE	DE4
Zizzle	F	F1
Zodiariah	DW	None
ZoeJ	K	K2
Zolita	A	A5
ZoMa	G	G1
Zombie	G	G1
Zonia	B	B1
ZooBear	BF	None
Zooman	GD	GD2
Zorro	AK	None
Zucker	FN	None
Zuko	BR	None
Zulu	A	A6
ZygoTaiga	C	C1
